60,69,184,180,146,157,796
14,24,62,70,67,79,316
5,13,29,30,20,21,118
23,28,86,84,61,74,356
50,70,180,192,168,177,837
8,15,36,38,34,28,159
38,57,145,150,127,134,651
21,24,71,76,61,75,328
22,28,73,72,62,69,326
44,61,171,177,153,172,778
26,31,81,93,73,76,380
23,31,70,59,45,57,285
21,34,83,77,66,81,362
26,38,91,87,70,65,377
5,10,18,30,32,23,118
19,16,57,61,57,58,268
11,17,39,43,34,30,174
21,29,70,82,76,64,342
13,15,53,60,48,62,251
12,13,53,54,45,48,225
20,22,52,61,56,47,258
20,21,64,70,50,58,283
37,52,133,140,125,131,618
23,33,76,65,64,65,326
51,67,188,199,166,163,834
21,30,77,71,55,64,318
29,39,101,102,89,103,463
21,32,87,98,80,75,393
49,64,199,189,157,155,813
12,18,45,41,31,29,176
11,15,58,56,50,54,244
45,60,161,165,151,165,747
22,38,88,97,91,91,427
23,36,98,100,80,105,442
51,64,186,179,161,175,816
29,61,135,153,138,129,645
20,23,85,100,60,39,327
15,19,60,62,59,65,280
19,35,118,109,69,72,422
21,45,124,116,82,81,469
41,55,135,150,130,138,649
36,57,142,146,136,127,644
42,56,178,184,160,159,779
45,57,169,162,135,146,714
23,36,115,113,77,63,427
24,29,87,89,88,94,411
27,22,67,79,76,82,353
26,37,105,109,91,94,462
50,67,164,155,139,138,713
7,8,18,19,14,19,85
23,28,76,83,77,78,365
7,11,21,23,14,15,91
43,54,144,147,131,127,646
20,20,72,73,55,54,294
21,24,71,72,60,66,314
24,26,69,77,67,67,330
24,39,90,80,79,91,403
5,5,12,9,7,10,48
20,42,128,117,69,36,412
10,12,35,34,26,22,139
25,26,77,82,79,96,385
19,32,72,62,66,56,307
17,25,70,89,76,82,359
36,49,131,140,123,118,597
20,37,116,116,72,54,415
14,21,58,71,57,55,276
15,23,67,75,52,39,271
23,19,58,62,56,54,272
47,64,188,199,174,158,830
30,43,95,94,87,79,428
25,38,96,108,99,103,469
44,62,170,170,145,144,735
44,58,173,185,170,168,798
45,62,183,178,167,163,798
26,30,82,79,70,71,358
8,17,39,40,44,44,192
33,41,105,114,89,96,478
18,25,66,84,78,78,349
33,50,127,124,103,107,544
22,34,87,99,87,88,417
19,47,115,119,81,54,435
39,60,145,141,124,121,630
42,55,156,149,130,140,672
24,25,79,83,72,68,351
43,60,162,155,140,163,723
17,39,114,107,68,50,395
26,36,115,114,72,50,413
20,38,115,109,78,63,423
34,54,141,155,136,135,655
18,25,56,62,52,43,256
29,36,97,108,92,92,454
26,27,68,72,78,87,358
34,46,126,142,123,121,592
21,36,96,104,94,91,442
43,59,158,153,130,140,683
51,68,172,184,184,194,853
26,30,72,64,61,76,329
11,29,91,88,52,31,302
5,8,19,13,11,13,69
28,45,113,111,104,98,499
45,70,179,185,144,151,774
30,32,96,113,90,89,450
54,65,179,181,160,159,798
29,37,104,97,79,87,433
28,38,95,84,74,90,409
41,58,157,170,140,144,710
13,21,53,44,28,31,190
15,35,104,91,56,47,348
13,12,31,34,26,35,151
32,38,95,107,87,91,450
19,37,94,81,64,58,353
48,60,156,168,152,136,720
21,28,85,88,66,57,345
24,38,126,141,87,66,482
33,41,105,114,88,93,474
20,39,113,112,68,52,404
23,26,72,72,73,95,361
21,35,97,103,83,92,431
19,24,69,76,69,77,334
44,60,167,186,161,148,766
12,27,58,64,61,50,272
25,52,142,137,102,73,531
13,19,50,37,36,40,195
19,23,58,59,51,53,263
36,56,141,145,124,137,639
47,60,162,182,150,162,763
37,58,144,146,126,134,645
33,44,98,108,99,103,485
45,59,177,186,168,163,798
20,44,133,130,92,80,499
12,22,67,74,44,28,247
25,45,124,127,86,64,471
17,38,115,101,74,68,413
35,54,136,145,125,124,619
23,26,76,89,81,74,369
31,53,148,149,126,131,638
46,63,178,189,167,168,811
15,26,73,85,73,55,327
27,51,156,160,108,86,588
9,17,49,50,42,37,204
47,58,167,165,139,143,719
21,30,75,71,58,62,317
11,15,40,44,36,36,182
6,14,29,38,29,23,139
17,22,48,56,49,48,240
16,17,61,67,51,37,249
25,36,95,88,71,77,392
32,36,104,100,82,96,450
22,25,77,77,66,74,341
44,61,161,164,141,158,729
34,39,106,107,87,94,467
35,53,151,148,127,140,654
18,35,91,94,63,60,361
29,38,96,101,88,74,426
16,21,55,47,55,57,251
25,40,105,113,96,86,465
47,68,174,187,174,180,830
37,48,128,133,125,124,595
13,40,93,95,69,53,363
17,25,67,72,58,65,304
11,21,52,65,54,54,257
42,60,150,155,143,147,697
20,39,120,118,74,63,434
19,47,134,140,95,63,498
21,33,93,93,74,77,391
14,14,42,37,36,29,172
4,6,6,5,8,8,37
26,30,80,102,84,73,395
29,27,81,90,87,85,399
41,59,176,180,166,160,782
22,24,59,48,42,50,245
15,25,91,96,50,37,314
42,67,179,175,156,158,777
3,7,7,5,8,8,38
14,17,45,46,54,55,231
33,51,139,155,134,127,639
18,27,69,70,63,60,307
20,31,70,74,72,78,345
43,58,169,157,125,143,695
24,29,73,57,41,45,269
38,48,135,140,111,111,583
23,24,67,72,76,91,353
7,7,10,17,13,8,62
22,42,122,131,84,73,474
21,25,67,62,46,50,271
30,26,80,82,75,88,381
47,72,173,162,154,150,758
47,66,188,175,160,168,804
38,60,173,161,131,134,697
4,5,6,8,5,7,35
17,18,59,69,54,49,266
30,43,107,107,97,95,479
16,19,46,41,43,40,205
50,65,175,172,161,157,780
29,42,90,89,86,84,420
27,24,67,81,76,82,357
23,40,109,124,80,60,436
26,36,115,112,72,52,413
26,34,118,119,80,68,445
21,50,149,137,92,76,525
11,16,26,26,21,26,126
15,11,43,43,34,30,176
30,37,96,95,81,99,438
21,30,78,75,69,87,360
8,9,11,19,17,24,88
2,6,13,21,17,23,82
23,49,128,128,89,74,491
22,31,77,85,73,85,373
16,18,53,51,48,49,235
36,54,149,152,133,130,654
41,54,151,142,121,143,652
21,33,75,70,63,57,319
12,39,88,77,61,52,329
30,38,91,84,75,91,409
22,55,142,138,90,70,517
26,52,142,129,76,73,498
10,20,54,69,67,76,296
43,56,179,176,155,151,760
18,23,62,57,41,47,248
47,55,177,178,168,164,789
39,60,168,179,156,152,754
26,36,93,81,67,66,369
28,30,81,84,77,93,393
17,29,89,84,59,59,337
31,38,102,107,96,109,483
31,40,108,106,84,90,459
24,32,86,95,82,78,397
34,48,122,114,99,127,544
11,12,30,31,28,31,143
24,32,75,77,70,57,335
16,16,50,67,53,66,268
19,20,57,59,46,46,247
25,29,92,97,85,98,426
28,35,88,101,87,80,419
6,12,19,22,19,24,102
34,45,123,115,100,112,529
43,64,177,177,167,158,786
45,69,175,174,166,164,793
38,56,149,155,133,134,665
15,37,103,102,67,63,387
11,17,44,45,39,41,197
11,9,28,18,19,17,102
20,29,77,71,63,68,328
15,27,77,76,52,56,303
25,35,83,101,79,78,401
18,39,120,111,66,38,392
20,17,56,65,49,54,261
26,28,89,82,75,82,382
22,31,81,88,88,87,397
5,14,20,19,15,16,89
37,48,130,139,129,128,611
35,56,153,157,132,129,662
17,43,120,124,82,50,436
51,58,176,176,149,156,766
8,19,45,46,34,37,189
29,41,92,87,71,76,396
33,33,83,96,85,88,418
7,5,9,6,6,8,41
25,35,118,109,60,64,411
34,42,109,101,98,115,499
6,11,16,18,15,21,87
29,45,106,121,111,101,513
47,64,185,188,163,170,817
10,30,82,103,71,41,337
30,45,99,107,101,94,476
21,36,96,103,93,93,442
26,32,89,93,91,83,414
36,45,115,113,97,112,518
33,46,135,143,120,137,614
16,46,147,146,99,80,534
26,33,101,107,82,102,451
48,63,191,186,157,162,807
43,66,176,157,145,141,728
42,58,148,152,133,132,665
25,44,106,107,89,111,482
2,0,6,9,9,12,38
23,44,146,143,104,73,533
25,53,137,133,87,73,508
31,38,114,109,80,98,470
23,28,90,97,85,87,410
27,34,85,96,85,80,407
21,33,96,104,70,56,380
42,69,179,181,163,167,801
24,32,79,81,80,94,390
17,39,95,93,67,50,361
17,12,49,50,27,31,186
41,55,174,173,145,156,744
9,11,37,36,25,25,143
37,49,129,123,101,112,551
39,55,159,161,125,123,662
20,23,72,82,59,66,322
15,24,63,65,49,50,266
25,45,125,135,105,109,544
26,31,97,102,85,87,428
10,12,48,53,53,60,236
42,55,132,128,114,124,595
17,33,108,111,80,74,423
30,37,97,108,82,83,437
7,9,24,27,29,28,124
28,37,110,115,103,103,496
7,15,32,34,26,26,140
8,19,46,41,43,42,199
39,66,133,136,134,117,625
43,60,155,148,128,118,652
34,45,124,116,100,113,532
11,21,73,74,49,34,262
20,44,113,110,79,65,431
33,43,113,114,107,103,513
5,6,7,6,3,3,30
16,15,43,40,46,41,201
18,33,86,85,70,80,372
35,49,123,124,108,135,574
21,28,90,98,78,68,383
41,64,163,162,145,145,720
30,37,100,97,96,99,459
23,57,141,132,85,75,513
36,54,127,130,114,129,590
44,56,157,182,169,148,756
17,39,115,99,76,71,417
23,33,82,88,68,63,357
46,61,167,172,149,156,751
33,48,110,128,116,109,544
21,38,79,81,65,88,372
46,62,166,169,145,143,731
51,72,189,186,171,170,839
54,60,178,158,146,144,740
19,26,72,74,63,66,320
10,22,44,36,39,28,179
36,51,131,135,122,125,600
34,37,104,116,93,110,494
38,59,150,160,142,149,698
3,1,2,6,8,6,26
24,41,101,90,81,98,435
19,24,74,81,71,76,345
37,57,136,150,131,131,642
16,47,145,145,97,81,531
4,11,32,39,30,32,148
11,31,99,98,59,62,360
16,41,121,124,80,70,452
36,48,137,155,131,129,636
24,35,96,93,91,100,439
36,63,145,150,129,120,643
23,26,83,102,76,76,386
20,28,73,89,74,83,367
23,30,78,71,62,72,336
12,24,55,67,58,51,267
46,62,167,170,145,143,733
45,67,186,190,170,185,843
4,6,3,8,6,2,29
42,56,158,173,141,152,722
22,48,132,131,87,72,492
47,58,158,161,135,149,708
33,56,135,135,114,111,584
18,27,68,69,54,82,318
17,23,69,73,46,46,274
2,3,5,5,5,11,31
16,24,61,71,58,60,290
4,11,19,20,14,17,85
20,28,63,65,69,71,316
13,34,83,82,63,69,344
18,31,79,62,59,68,317
22,30,67,54,58,54,285
22,35,81,76,68,70,352
25,39,100,96,81,109,450
23,34,88,97,96,90,428
22,23,73,64,56,75,313
20,29,86,90,81,90,396
19,31,84,74,53,71,332
19,32,87,90,78,84,390
0,2,2,1,1,4,10
2,3,9,15,13,11,53
3,7,15,22,12,4,63
23,33,85,87,72,66,366
21,31,77,73,60,59,321
46,67,173,172,154,150,762
13,23,67,76,59,65,303
10,24,66,68,52,33,253
11,11,31,47,37,20,157
44,49,145,161,132,145,676
40,57,162,164,146,151,720
10,16,48,60,41,42,217
36,59,151,138,116,114,614
39,56,148,146,117,125,631
43,61,159,166,141,160,730
22,37,112,105,71,61,408
38,60,158,167,139,146,708
38,49,146,147,131,125,636
2,3,7,6,6,7,31
44,53,148,136,124,109,614
2,6,16,15,15,15,69
40,57,142,128,111,133,611
36,52,135,129,121,131,604
19,18,61,65,47,63,273
21,32,88,99,79,74,393
30,37,106,106,87,100,466
15,35,97,91,56,56,350
39,52,142,150,138,147,668
4,8,31,40,29,28,140
41,49,155,161,132,144,682
12,20,63,58,45,33,231
45,59,161,152,131,139,687
38,45,133,137,123,130,606
9,7,35,45,37,39,172
29,43,99,98,76,96,441
40,49,136,136,110,131,602
19,29,73,81,76,73,351
32,56,143,148,133,136,648
17,36,115,112,69,45,394
33,49,151,152,129,132,646
49,65,163,159,139,141,716
18,26,61,69,69,61,304
30,49,131,129,116,139,594
39,53,140,139,117,128,616
32,47,118,128,105,96,526
3,3,5,6,6,3,26
12,30,87,91,72,67,359
24,41,120,116,69,51,421
16,15,43,39,44,38,195
2,2,4,9,6,6,29
15,21,68,56,48,65,273
28,40,109,118,101,106,502
18,41,105,105,85,71,425
4,4,7,11,9,7,42
9,4,15,21,22,23,94
1,2,1,3,3,9,19
22,37,119,118,68,60,424
50,77,183,170,143,147,770
22,29,69,71,64,70,325
25,38,96,90,85,95,429
10,12,42,52,37,29,182
39,58,160,169,144,142,712
14,33,108,104,59,56,374
22,45,123,97,64,60,411
10,22,61,51,50,56,250
50,58,157,158,135,149,707
4,3,3,2,1,8,21
34,52,138,140,128,123,615
4,7,16,13,10,13,63
42,56,162,168,156,160,744
23,32,102,103,85,89,434
4,4,10,12,12,11,53
34,53,143,134,112,123,599
18,33,94,68,46,37,296
15,21,61,77,61,64,299
44,64,173,171,137,154,743
9,24,57,55,30,32,207
20,33,77,64,57,66,317
29,31,98,88,82,81,409
40,66,184,173,142,141,746
2,0,2,4,4,3,15
11,38,104,103,70,59,385
9,15,52,47,34,38,195
21,31,83,95,82,89,401
8,11,40,44,28,29,160
11,15,35,29,23,30,143
38,50,134,134,111,120,587
44,66,177,165,154,149,755
3,4,6,1,0,6,20
13,26,98,108,68,43,356
40,55,142,131,116,130,614
37,57,154,163,128,117,656
48,64,165,175,163,163,778
14,37,114,115,77,64,421
4,10,16,14,11,13,68
16,23,61,65,49,48,262
44,61,177,166,153,156,757
12,33,96,91,56,48,336
4,7,12,13,8,3,47
6,5,7,9,6,5,38
36,46,120,143,111,115,571
40,59,174,170,157,171,771
36,52,133,133,111,121,586
50,60,172,183,158,157,780
34,51,131,146,114,118,594
33,47,140,143,132,129,624
38,54,147,143,115,127,624
46,52,152,139,112,113,614
23,38,100,115,98,100,474
27,22,71,78,71,70,339
20,47,133,114,67,54,435
42,56,170,162,145,152,727
15,19,46,57,52,38,227
37,50,129,132,130,132,610
39,58,160,169,144,142,712
6,5,15,18,16,9,69
17,18,66,82,63,68,314
5,5,13,26,26,12,87
29,50,142,149,128,126,624
22,51,143,133,94,79,522
5,4,5,3,5,7,29
38,47,134,149,130,130,628
19,41,102,103,67,55,387
53,67,163,173,147,171,774
5,5,3,4,4,5,26
26,41,101,110,94,81,453
35,39,96,100,84,98,452
50,53,151,159,155,148,716
11,15,36,33,32,38,165
17,29,75,84,71,66,342
31,55,121,133,126,139,605
47,64,191,170,139,149,760
21,30,90,84,66,84,375
30,52,147,158,136,126,649
5,9,19,17,12,13,75
44,55,150,151,129,138,667
37,50,132,133,121,131,604
48,61,162,164,149,148,732
2,0,2,4,4,3,15
43,59,171,171,154,139,737
44,60,174,172,145,169,764
45,57,152,161,137,132,684
50,65,173,159,141,146,734
4,3,2,5,4,7,25
2,2,4,2,3,1,14
15,18,62,64,52,41,252
10,17,45,37,37,31,177
32,51,130,142,121,119,595
46,65,174,169,150,148,752
1,1,3,1,3,6,15
36,57,159,139,119,132,642
16,36,104,88,65,69,378
45,65,171,169,144,159,753
27,40,112,109,96,93,477
40,55,140,153,142,140,670
3,7,11,10,11,13,55
35,53,156,170,152,147,713
4,11,24,20,10,16,85
17,38,139,137,90,72,493
32,52,145,145,127,132,633
25,33,85,83,74,85,385
34,55,136,128,122,118,593
26,34,90,97,78,83,408
48,67,177,167,152,161,772
2,6,17,26,27,24,102
39,46,123,116,104,113,541
21,33,86,77,68,77,362
22,29,77,82,67,75,352
40,48,141,141,114,118,602
16,27,82,90,66,62,343
38,49,137,143,126,125,618
46,65,177,181,154,161,784
9,34,90,73,59,41,306
44,62,166,157,141,144,714
25,30,88,94,89,91,417
28,42,119,123,113,112,537
5,10,21,27,18,20,101
44,56,152,148,134,149,683
14,36,109,114,79,55,407
23,38,96,103,87,89,436
22,43,111,100,63,48,387
1,1,9,19,13,11,54
37,62,163,176,144,141,723
43,49,158,148,124,116,638
0,2,2,0,1,1,6
20,25,67,76,67,71,326
21,25,72,78,74,72,342
22,28,81,83,71,71,356
16,37,118,117,87,76,451
10,13,51,59,42,41,216
11,15,47,41,34,34,182
20,46,147,158,112,90,573
21,28,66,74,69,74,332
27,66,195,206,147,115,756
1,1,2,2,3,1,10
2,2,4,2,0,2,12
25,39,113,117,85,108,487
21,51,149,162,124,95,602
27,55,173,162,103,96,616
29,46,119,106,82,101,483
29,36,98,103,90,93,449
22,30,64,64,60,60,300
27,50,150,141,99,88,555
9,16,44,54,37,43,203
6,4,4,5,5,5,29
11,18,48,52,43,43,215
0,1,1,0,2,8,12
12,15,44,39,30,30,170
24,44,132,135,90,79,504
31,65,210,195,134,110,745
23,24,65,69,59,58,298
26,53,149,148,88,78,542
21,41,117,103,63,49,394
13,14,36,40,39,38,180
4,4,4,2,2,6,22
13,17,44,50,39,45,208
23,33,83,79,71,62,351
25,29,97,91,84,83,409
2,11,19,8,9,9,58
7,4,5,10,9,7,42
25,26,87,84,74,85,381
18,27,79,85,74,82,365
26,43,98,105,89,94,455
14,17,42,46,36,39,194
24,36,130,127,82,80,479
18,19,72,79,62,58,308
18,32,94,97,61,52,354
29,58,185,184,124,110,690
7,5,9,8,3,7,39
19,40,96,94,74,64,387
3,3,2,3,3,4,18
27,58,186,183,124,111,689
1,3,8,12,13,11,48
24,54,169,161,109,87,604
25,36,91,94,71,74,391
13,18,50,51,42,42,216
17,33,126,132,85,65,458
28,59,149,147,120,93,596
31,59,187,185,127,98,687
18,22,59,71,62,59,291
2,0,2,1,1,0,6
30,44,101,91,93,96,455
23,29,72,94,76,63,357
13,21,50,59,43,41,227
21,33,78,86,75,81,374
18,24,62,74,66,60,304
26,27,95,103,85,89,425
30,32,100,99,91,105,457
28,61,192,194,135,98,708
17,28,81,74,50,45,295
30,32,103,103,90,85,443
15,28,104,112,73,49,381
20,30,77,89,86,79,381
32,59,185,176,114,100,666
24,35,84,81,75,90,389
13,21,60,56,44,34,228
16,24,78,76,52,63,309
10,15,31,34,28,33,151
16,19,61,64,47,48,255
7,13,33,30,24,35,142
6,3,5,3,5,9,31
25,28,71,67,57,66,314
28,67,201,204,137,101,738
26,38,140,125,82,66,477
14,21,50,42,40,38,205
3,5,6,6,4,9,33
35,67,197,186,122,98,705
3,4,2,7,13,6,35
1,0,1,2,1,2,7
10,28,94,101,71,62,366
14,22,62,58,44,40,240
31,61,184,176,122,104,678
5,8,11,8,7,11,50
17,43,122,123,80,72,457
26,59,158,151,116,92,602
26,26,92,90,77,85,396
22,35,132,123,82,63,457
23,30,73,66,62,89,343
12,13,41,43,39,31,179
29,58,180,193,131,95,686
31,49,112,107,99,110,508
1,0,1,1,1,2,6
3,3,3,6,4,5,24
15,39,117,113,72,53,409
28,39,85,87,71,69,379
17,36,78,83,71,72,357
27,42,111,114,108,109,511
5,8,4,5,3,2,27
14,17,46,49,42,37,205
21,30,82,86,79,81,379
14,35,105,95,66,64,379
13,12,37,39,36,35,172
8,14,41,40,30,29,162
29,57,162,154,114,93,609
3,1,3,4,5,4,20
0,2,3,4,3,0,12
26,65,157,162,132,95,637
21,27,73,82,68,67,338
1,3,4,3,3,8,22
30,50,105,121,107,95,508
29,68,197,199,145,115,753
22,30,90,90,81,78,391
3,5,2,3,3,8,24
2,2,2,4,6,4,20
3,3,6,12,7,6,37
12,24,64,63,41,43,247
17,15,44,31,25,29,161
15,32,109,113,77,58,404
2,3,1,0,1,1,8
25,52,165,161,111,74,588
8,18,44,48,38,22,178
7,12,36,39,29,29,152
12,15,45,48,32,33,185
4,4,4,5,3,0,20
26,36,99,93,65,107,426
3,2,4,4,6,5,24
5,14,30,33,28,27,137
16,33,91,80,68,58,346
23,24,61,70,67,63,308
10,14,31,24,21,22,122
12,7,20,28,25,19,111
33,38,101,102,87,62,423
2,1,4,3,1,3,14
4,3,3,3,2,8,23
30,59,183,163,114,91,640
28,37,125,125,106,115,536
6,4,5,10,9,6,40
25,38,96,109,88,98,454
33,65,190,182,123,101,694
21,34,90,97,92,93,427
3,2,1,4,2,2,14
17,30,84,90,67,81,369
12,18,49,46,37,39,201
27,55,160,159,123,104,628
7,12,37,39,28,24,147
23,46,149,148,103,88,557
11,14,50,46,37,33,191
19,21,65,63,42,46,256
24,56,146,142,110,89,567
15,39,115,114,72,52,407
34,68,207,204,133,103,749
17,26,52,62,47,44,248
23,22,83,61,41,64,294
19,29,77,69,53,64,311
14,33,90,105,70,47,359
25,58,168,168,116,97,632
10,7,8,9,8,7,49
10,22,59,57,45,38,231
19,36,106,103,97,93,454
29,31,87,84,66,61,358
39,50,145,144,131,134,643
20,21,58,59,46,43,247
48,61,167,165,157,163,761
3,5,4,5,5,10,32
8,11,23,27,20,28,117
9,15,34,30,31,30,149
25,33,96,101,90,101,446
23,32,81,101,92,90,419
16,25,72,80,71,63,327
27,35,90,99,85,93,429
43,56,157,157,129,131,673
26,35,93,90,87,89,420
26,33,110,126,101,103,499
29,41,101,103,93,91,458
20,32,88,106,86,71,403
6,3,12,13,10,16,60
43,66,170,169,140,135,723
29,46,105,121,103,105,509
43,68,173,150,120,133,687
2,3,2,3,3,1,14
23,27,65,77,75,57,324
18,26,79,92,77,69,361
35,42,119,123,103,111,533
18,16,58,53,40,48,233
22,26,70,83,77,79,357
41,58,154,159,141,136,689
41,54,154,152,124,129,654
43,54,142,134,124,128,625
27,41,103,122,92,105,490
46,59,159,159,141,142,706
43,49,147,161,136,136,672
37,48,137,141,128,132,623
49,61,149,147,128,128,662
35,67,197,188,124,92,703
1,1,6,3,0,4,15
28,37,123,142,102,102,534
22,25,88,97,76,81,389
0,1,3,4,2,0,10
33,65,202,194,132,108,734
38,49,133,137,106,116,579
31,47,120,114,107,111,530
17,14,54,51,39,28,203
48,58,156,162,142,134,700
35,50,137,145,124,137,628
29,37,127,134,114,115,556
10,7,21,27,21,14,100
36,58,136,134,120,126,610
21,33,87,86,77,84,388
27,28,93,97,78,94,417
7,7,12,8,11,19,64
18,24,69,75,67,76,329
34,47,134,134,115,114,578
40,49,140,143,127,141,640
38,48,137,129,124,132,608
10,10,28,27,29,26,130
42,55,137,139,129,142,644
2,2,4,6,8,8,30
42,54,154,158,143,137,688
30,41,106,99,104,98,478
33,36,108,113,107,112,509
33,45,134,137,112,108,569
45,64,172,167,147,143,738
29,49,107,105,95,104,489
14,20,40,46,49,61,230
5,7,18,18,15,13,76
2,2,1,4,3,4,16
42,58,148,152,141,139,680
1,2,3,4,6,4,20
32,46,137,136,119,121,591
17,30,73,69,65,71,325
26,41,115,118,101,93,494
32,46,131,131,110,125,575
26,27,72,77,68,66,336
28,52,141,153,130,132,636
27,33,107,108,113,109,497
12,24,46,44,43,48,217
27,31,92,104,89,100,443
0,0,0,1,1,2,4
45,56,150,141,116,123,631
39,56,155,149,134,153,686
43,62,162,162,139,151,719
28,48,112,134,119,118,559
27,37,89,89,84,87,413
38,46,121,131,109,121,566
13,18,59,60,56,58,264
36,50,137,128,103,113,567
44,51,138,131,117,120,601
8,8,15,15,9,14,69
31,59,195,188,127,101,701
14,14,60,64,55,54,261
39,48,137,137,119,128,608
46,60,161,162,146,146,721
3,3,5,4,3,4,22
18,24,57,58,51,54,262
29,39,107,107,95,98,475
1,3,6,5,4,7,26
4,1,6,4,5,12,32
23,36,99,120,108,100,486
42,53,144,141,116,125,621
47,54,157,164,136,134,692
39,47,138,149,128,137,638
26,42,116,118,102,99,503
37,47,135,139,116,125,599
26,40,114,118,101,93,492
24,27,74,72,76,80,353
36,55,132,134,113,107,577
25,40,106,111,90,95,467
8,8,6,3,3,4,32
35,53,134,138,130,124,614
40,55,145,144,131,134,649
42,62,145,149,143,140,681
30,34,104,108,102,96,474
37,41,114,106,92,95,485
13,13,45,50,44,46,211
9,8,23,20,25,23,108
28,41,107,99,78,90,443
28,29,92,87,66,71,373
40,47,136,136,117,121,597
31,39,110,130,120,109,539
48,55,162,174,146,138,723
24,37,98,92,73,76,400
47,54,151,156,136,148,692
28,45,118,115,111,113,530
2,4,4,1,1,6,18
32,47,135,133,108,110,565
49,58,157,161,148,150,723
35,59,183,175,120,102,674
42,53,135,137,117,118,602
35,52,119,120,126,133,585
1,1,4,4,5,4,19
2,2,3,1,2,3,13
35,43,126,137,125,110,576
32,48,113,121,128,133,575
15,14,43,43,35,45,195
23,33,91,80,63,66,356
38,56,153,153,138,150,688
26,43,97,97,89,89,441
41,60,156,162,141,149,709
4,4,11,9,7,7,42
35,66,193,199,128,118,739
37,51,140,155,124,117,624
25,43,114,121,109,103,515
11,15,36,30,24,29,145
2,2,8,8,5,5,30
8,10,25,29,29,27,128
12,16,41,39,31,33,172
9,11,24,18,15,18,95
0,37,59,67,44,0,207
0,38,73,65,42,0,218
0,34,63,54,37,0,188
0,38,62,73,47,0,220
0,30,44,57,39,0,170
0,12,20,16,9,0,57
0,22,36,33,20,0,111
0,32,52,54,34,0,172
0,24,36,36,24,0,120
0,26,43,49,32,0,150
0,19,31,31,20,0,101
0,2,2,6,5,0,15
0,5,12,15,9,0,41
0,35,55,56,36,0,182
0,0,0,3,3,0,6
0,29,54,58,37,0,178
0,1,2,4,3,0,10
0,31,46,45,30,0,152
0,31,48,50,33,0,162
0,30,49,61,37,0,177
0,1,0,2,2,0,5
0,24,39,42,25,0,130
0,34,52,49,30,0,165
0,37,55,49,31,0,172
0,2,4,7,4,0,17
0,26,46,49,34,0,155
0,23,35,33,23,0,114
0,35,51,54,37,0,177
0,2,3,2,1,0,8
0,35,50,50,31,0,166
0,35,55,53,32,0,175
0,26,40,43,29,0,138
0,22,34,29,20,0,105
0,24,40,46,28,0,138
0,29,47,54,36,0,166
0,32,47,49,33,0,161
0,29,46,53,36,0,164
0,18,34,41,25,0,118
0,31,48,50,34,0,163
0,29,48,52,34,0,163
0,32,52,52,31,0,167
0,4,9,12,5,0,30
0,33,50,52,34,0,169
0,31,50,54,34,0,169
0,41,55,64,36,0,196
0,24,36,49,29,0,138
0,35,48,56,33,0,172
0,35,45,52,29,0,161
0,41,55,64,36,0,196
0,31,46,59,36,0,172
0,15,20,26,15,0,76
0,7,12,12,7,0,38
0,31,48,53,36,0,168
0,34,47,50,28,0,159
0,11,15,16,11,0,53
0,28,47,56,35,0,166
0,9,8,9,7,0,33
0,20,33,38,21,0,112
0,29,48,60,32,0,169
0,28,49,56,31,0,164
0,6,7,7,5,0,25
0,1,2,2,1,0,6
0,11,12,18,13,0,54
0,18,26,23,13,0,80
0,27,46,52,32,0,157
0,5,8,8,5,0,26
0,0,1,2,1,0,4
0,19,34,39,23,0,115
0,12,20,12,5,0,49
0,25,39,55,35,0,154
0,3,5,3,1,0,12
11,18,52,46,40,47,214
47,70,179,173,147,163,779
25,27,72,85,85,77,371
12,19,38,39,34,25,167
36,57,143,140,121,132,629
44,55,162,166,151,166,744
50,65,179,178,149,165,786
46,68,177,180,160,162,793
43,61,172,176,159,157,768
31,45,114,116,115,108,529
12,23,47,47,38,33,200
56,72,192,186,165,169,840
7,15,32,34,26,26,140
39,54,135,133,120,134,615
45,68,192,187,141,148,781
57,72,192,186,165,169,841
58,77,181,185,165,169,835
52,73,190,172,158,146,791
49,69,173,158,140,153,742
9,14,29,27,21,23,123
14,22,45,37,36,38,192
12,22,42,43,38,33,190
53,75,196,182,146,148,800
10,14,29,36,24,25,138
58,73,193,185,153,156,818
43,62,172,170,152,133,732
53,70,186,196,169,169,843
46,67,190,194,159,155,811
13,22,40,44,38,41,198
45,64,151,159,133,134,686
53,72,188,189,161,189,852
29,40,111,111,87,100,478
44,66,185,194,160,161,810
10,16,41,40,43,37,187
13,20,48,46,43,45,215
32,46,117,124,116,115,550
37,58,142,147,126,142,652
38,61,161,170,143,160,733
42,64,155,144,125,139,669
24,33,83,83,74,83,380
22,48,137,139,96,80,522
35,34,101,95,85,100,450
44,56,157,161,133,142,693
10,18,44,45,38,34,189
38,64,162,166,134,136,700
38,51,142,153,137,153,674
10,15,31,34,27,27,144
43,56,156,161,133,140,689
51,66,182,186,149,166,800
44,58,165,173,138,148,726
58,68,183,177,164,168,818
49,67,186,193,151,140,786
39,62,173,174,142,138,728
11,21,42,50,32,34,190
42,60,152,162,149,147,712
50,67,191,180,146,156,790
49,65,190,201,175,176,856
21,31,79,74,60,67,332
13,20,48,45,39,36,201
49,65,174,189,155,146,778
51,73,195,202,181,189,891
8,14,38,40,30,31,161
44,76,184,183,164,163,814
47,56,153,153,132,151,692
42,64,174,172,150,159,761
48,64,180,187,157,174,810
33,53,130,141,136,130,623
5,3,5,3,4,4,24
51,66,182,176,150,162,787
51,67,189,205,180,175,867
54,76,184,181,158,161,814
53,62,173,180,174,172,814
51,65,180,177,158,155,786
40,71,187,197,170,168,833
39,64,153,153,129,140,678
34,65,158,165,141,156,719
27,42,105,106,91,96,467
51,74,177,201,177,175,855
31,38,95,96,80,75,415
43,57,147,149,131,116,643
47,58,154,151,139,147,696
52,66,184,182,160,177,821
47,67,186,188,154,160,802
13,18,42,45,35,37,190
32,57,129,145,136,144,643
56,67,193,196,159,157,828
43,53,160,176,147,167,746
13,19,41,48,38,37,196
15,17,46,62,37,41,218
24,32,94,91,72,88,401
38,60,158,176,163,153,748
18,32,67,71,69,60,317
38,62,151,152,137,124,664
45,66,162,158,135,146,712
43,57,153,152,136,140,681
43,63,141,138,126,124,635
13,19,54,57,49,39,231
46,73,170,184,145,163,781
25,27,77,85,65,71,350
35,44,123,127,103,103,535
44,61,157,160,142,152,716
40,63,167,174,141,154,739
58,77,181,185,166,168,835
18,24,63,72,71,66,314
53,62,176,174,144,158,767
49,69,187,189,171,181,846
35,48,144,159,141,173,700
39,58,162,160,132,135,686
35,55,141,144,123,125,623
36,59,140,144,133,131,643
15,21,43,49,37,43,208
55,73,193,193,156,168,838
35,59,130,129,119,117,589
40,62,167,172,142,152,735
11,15,32,32,36,28,154
24,29,84,91,76,73,377
46,65,184,188,169,187,839
53,67,180,202,171,170,843
49,72,181,183,160,162,807
7,13,37,38,29,28,152
31,54,134,154,128,146,647
47,66,176,185,164,162,800
4,13,35,35,24,29,140
9,12,38,35,31,23,148
43,58,172,170,140,157,740
46,71,190,203,173,169,852
10,19,45,39,37,42,192
51,60,181,178,163,166,799
42,55,159,159,138,155,708
48,63,170,176,170,173,800
49,67,180,179,155,161,791
49,70,178,183,171,180,831
40,51,145,141,120,116,613
2,31,51,58,42,10,194
50,70,184,190,174,177,845
43,69,192,189,156,163,812
27,50,126,136,120,105,564
44,68,177,178,157,150,774
17,32,80,76,64,74,343
0,1,3,3,2,1,10
1,1,7,6,3,5,23
48,64,174,183,161,168,798
48,65,172,191,179,171,826
50,64,179,184,160,180,817
46,62,162,179,169,183,801
20,35,81,77,66,75,354
51,75,182,188,156,183,835
48,72,188,191,173,186,858
52,66,189,200,182,170,859
47,69,184,192,171,173,836
53,63,182,194,160,174,826
49,70,180,186,168,172,825
50,63,182,178,150,157,780
46,65,179,191,166,173,820
49,69,176,171,149,165,779
49,69,177,172,149,165,781
50,63,182,178,150,157,780
52,62,179,195,164,169,821
49,62,161,173,165,165,775
0,0,1,1,0,0,2
49,70,187,189,166,167,828
54,67,180,182,166,186,835
50,65,177,189,160,153,794
46,61,170,171,153,157,758
49,67,181,200,183,170,850
45,67,175,182,170,166,805
48,70,196,189,169,193,865
40,66,172,169,147,162,756
44,66,192,192,158,179,831
46,69,181,184,159,163,802
53,71,189,183,168,182,846
47,64,175,176,164,168,794
46,65,178,197,163,164,813
45,66,185,194,160,174,824
53,72,177,185,157,172,816
45,68,175,184,161,167,800
8,9,45,37,35,22,156
17,40,112,116,72,59,416
29,58,181,162,109,88,627
16,20,53,55,46,42,232
12,19,51,45,34,32,193
30,47,102,99,91,96,465
10,15,57,60,51,55,248
13,18,47,52,47,44,221
22,33,98,89,68,61,371
23,48,167,165,113,94,610
26,33,90,103,92,101,445
34,43,121,109,103,110,520
34,43,122,143,140,126,608
49,64,171,170,160,174,788
24,46,85,92,94,91,432
43,55,153,163,139,142,695
27,37,97,96,77,93,427
41,57,157,157,145,155,712
44,66,167,167,148,152,744
51,68,176,190,168,158,811
44,54,156,170,146,154,724
473,1232,2452,2474,1963,2461,11055
38,48,150,157,131,123,647
40,62,163,165,138,147,715
26,32,83,82,73,86,382
13,29,70,75,65,58,310
49,70,188,190,162,173,832
45,65,187,179,144,173,793
19,30,87,79,46,62,323
28,37,105,110,94,102,476
29,34,104,106,97,73,443
43,67,180,186,156,166,798
20,22,73,68,60,54,297
30,48,114,113,116,133,554
51,69,191,197,162,162,832
43,61,170,166,133,144,717
43,71,173,180,157,154,778
20,33,68,84,78,79,362
384,928,1887,1885,1494,1883,8461
31,46,99,108,104,100,488
53,72,199,190,159,167,840
35,48,143,151,135,140,652
23,35,96,108,94,99,455
16,21,59,58,60,79,293
22,38,88,97,91,90,426
18,31,88,87,80,87,391
41,54,147,150,138,160,690
31,38,107,118,107,101,502
51,64,178,186,150,158,787
13,22,61,70,65,50,281
25,37,97,96,85,90,430
42,58,161,157,137,143,698
25,44,112,125,114,103,523
37,44,118,128,119,119,565
41,62,169,177,159,167,775
45,67,184,196,163,158,813
15,25,66,76,64,62,308
23,40,106,110,92,94,465
32,31,104,102,93,82,444
40,52,149,154,135,150,680
49,61,167,171,146,161,755
18,22,62,62,55,73,292
46,64,166,173,145,160,754
43,64,184,186,157,164,798
48,70,187,191,157,152,805
44,64,174,174,152,162,770
54,71,192,180,149,161,807
27,43,117,123,106,94,510
40,57,149,151,130,136,663
32,48,136,140,122,128,606
31,42,118,119,94,85,489
20,30,88,94,78,54,364
40,57,149,139,116,136,637
26,47,113,114,96,96,492
18,25,75,77,69,69,333
32,46,121,118,104,122,543
50,69,177,182,163,157,798
21,22,89,82,60,66,340
48,64,176,178,150,167,783
14,19,58,59,42,54,246
43,61,174,166,146,158,748
41,55,145,137,116,132,626
26,41,96,88,85,92,428
27,42,116,110,93,85,473
30,45,121,132,121,129,578
49,63,172,157,138,155,734
42,66,163,158,128,148,705
45,50,144,135,139,143,656
33,50,133,136,114,114,580
23,30,86,105,91,104,439
23,31,76,85,86,77,378
29,43,130,150,128,137,617
36,48,133,130,124,132,603
42,56,163,168,139,146,714
46,66,169,167,139,157,744
35,56,161,164,126,135,677
30,52,122,120,102,97,523
46,61,164,166,139,144,720
36,61,163,160,148,149,717
49,63,178,188,165,155,798
30,44,103,98,78,95,448
50,72,190,193,165,173,843
46,64,176,174,158,161,779
38,53,136,131,123,127,608
40,61,151,151,134,135,672
28,28,78,86,78,80,378
22,26,63,76,70,78,335
26,35,99,99,86,85,430
36,50,138,132,119,130,605
41,52,155,154,139,136,677
51,65,175,179,160,156,786
3,2,3,3,4,6,21
32,46,129,136,117,106,566
36,42,127,133,121,126,585
34,49,140,146,125,145,639
36,46,124,133,121,121,581
33,40,111,105,87,101,477
44,54,142,135,130,137,642
26,37,103,94,90,105,455
22,36,106,125,109,102,500
26,36,104,111,95,109,481
5,7,3,2,4,2,23
29,51,118,125,117,122,562
40,56,153,153,132,136,670
47,67,169,171,157,156,767
36,43,105,118,104,109,515
28,43,105,100,80,91,447
31,45,119,107,95,94,491
26,43,97,94,92,84,436
34,44,129,149,138,124,618
15,26,64,67,76,84,332
22,26,75,89,76,83,371
18,26,68,60,55,76,303
17,25,67,67,52,54,282
19,26,67,91,77,71,351
29,50,121,116,100,105,521
49,65,190,201,158,164,827
49,71,183,174,146,164,787
14,14,64,71,49,51,263
47,68,186,182,162,173,818
38,51,142,139,124,130,624
38,65,164,171,149,161,748
52,69,180,184,168,168,821
30,50,116,130,116,113,555
41,58,138,153,136,140,666
51,76,202,194,163,176,862
997,2711,5413,5461,4389,5384,24355
34,43,117,132,111,103,540
45,71,172,172,157,165,782
46,70,188,189,156,179,828
47,69,181,177,154,164,792
45,64,181,194,168,163,815
51,73,207,201,172,187,891
3,0,6,8,4,9,30
41,55,127,127,122,140,612
54,69,188,197,166,159,833
41,63,168,167,146,141,726
35,52,125,121,94,101,528
35,51,147,151,122,100,606
42,59,169,169,145,140,724
33,50,131,130,120,124,588
44,66,172,179,158,154,773
49,66,180,189,164,163,811
42,59,161,167,162,165,756
33,46,126,125,114,126,570
0,42,67,60,34,0,203
29,47,120,131,109,117,553
45,60,140,160,129,141,675
33,51,134,133,109,95,555
45,61,174,176,162,164,782
37,61,152,153,143,142,688
46,65,192,184,163,169,819
51,74,194,186,170,194,869
37,52,128,128,116,139,600
41,60,174,178,153,158,764
37,38,127,136,111,113,562
45,75,185,181,161,163,810
49,68,173,173,153,166,782
115,203,475,488,428,475,2184
27,39,117,120,103,116,522
47,66,181,185,163,173,815
40,48,138,145,127,156,654
42,58,169,174,149,155,747
31,57,131,138,119,115,591
34,42,117,124,108,114,539
45,77,182,179,161,161,805
49,69,186,179,157,165,805
19,16,61,54,50,55,255
45,75,179,181,162,167,809
44,63,161,163,145,165,741
51,65,185,186,155,159,801
46,72,173,169,152,164,776
33,46,131,130,105,112,557
42,60,163,162,142,150,719
52,66,178,165,154,161,776
41,60,171,167,150,162,751
50,64,194,193,172,161,834
47,73,186,189,164,168,827
0,39,58,49,34,0,180
46,64,166,164,149,152,741
51,71,185,180,159,153,799
42,58,163,171,148,146,728
38,55,133,127,115,111,579
12,30,91,87,59,53,332
43,63,170,175,151,154,756
44,69,175,174,159,166,787
39,50,125,121,98,119,552
26,38,98,113,92,96,463
42,63,152,156,144,169,726
30,44,118,123,105,103,523
33,38,106,116,89,81,463
43,55,135,135,113,128,609
47,72,183,183,151,168,804
38,52,137,126,112,118,583
44,57,142,158,138,141,680
43,69,188,187,160,154,801
39,52,143,151,133,138,656
49,70,172,180,174,180,825
39,61,169,169,149,163,750
32,48,128,147,129,127,611
38,53,142,133,116,117,599
48,58,154,157,139,143,699
0,38,61,58,33,0,190
46,62,169,184,158,182,801
23,47,150,141,110,94,565
34,35,111,124,117,130,551
48,75,209,204,179,190,905
15,23,63,66,47,55,269
13,43,124,105,73,60,418
19,25,60,69,50,50,273
37,53,148,159,133,144,674
4,30,71,81,42,10,238
0,41,72,64,42,0,219
18,27,55,62,46,46,254
33,45,115,103,90,112,498
30,46,125,133,115,121,570
43,61,140,140,118,122,624
47,73,169,167,140,166,762
45,61,152,164,141,130,693
20,43,144,146,93,66,512
11,21,58,63,47,48,248
50,67,211,202,164,170,864
24,37,110,122,85,88,466
0,34,58,68,46,0,206
13,18,51,65,44,44,235
18,26,61,62,48,63,278
17,24,59,62,50,41,253
49,67,168,172,150,162,768
49,64,156,159,134,159,721
53,67,163,169,149,160,761
33,45,116,124,106,111,535
41,68,239,239,160,135,882
30,52,142,138,112,86,560
15,40,94,99,71,46,365
14,28,55,71,45,50,263
28,60,129,124,108,107,556
18,24,63,72,54,51,282
15,23,58,59,54,57,266
48,64,169,171,149,168,769
54,64,158,168,146,148,738
0,40,66,71,39,0,216
44,78,231,221,150,133,857
19,21,62,62,52,45,261
41,57,129,144,126,130,627
48,56,152,156,133,149,694
48,61,154,149,136,139,687
43,63,161,173,150,144,734
39,58,136,131,113,130,607
38,56,159,164,144,148,709
0,35,61,62,33,0,191
43,68,160,155,136,138,700
46,63,180,186,154,160,789
39,49,130,140,132,142,632
45,63,166,176,153,144,747
17,24,64,63,55,50,273
20,23,60,65,48,43,259
0,34,65,72,39,0,210
12,18,61,61,45,50,247
44,58,151,153,134,145,685
17,37,98,84,65,68,369
32,62,221,219,151,131,816
2,35,65,71,43,18,234
43,64,153,167,149,138,714
23,30,84,91,89,78,395
9,17,48,62,45,43,224
19,29,56,59,50,48,261
37,54,126,154,132,127,630
49,70,170,178,150,159,776
38,52,130,129,108,129,586
42,55,136,141,127,144,645
48,62,151,165,139,150,715
47,62,173,180,152,155,769
29,40,112,127,112,102,522
38,77,231,230,156,137,869
47,60,162,161,135,152,717
49,71,178,184,144,158,784
53,67,163,169,149,160,761
17,19,58,70,55,43,262
35,68,226,220,148,133,830
39,68,213,212,149,146,827
35,60,208,199,134,116,752
46,60,171,175,143,155,750
29,50,123,138,111,115,566
34,68,215,211,143,116,787
15,22,55,66,55,48,261
44,65,170,187,166,157,789
49,65,169,179,156,158,776
23,33,80,83,58,64,341
48,63,165,171,153,158,758
50,69,167,168,143,151,748
9,40,73,81,44,22,269
39,53,127,124,102,110,555
47,60,180,185,158,160,790
17,23,51,60,47,54,252
49,67,163,174,146,153,752
0,36,59,71,42,0,208
53,73,187,195,165,169,842
0,36,68,72,36,0,212
18,24,63,66,48,47,266
18,22,54,67,51,48,260
40,51,134,142,128,148,643
37,49,119,117,97,110,529
0,42,74,76,42,0,234
0,39,68,68,46,0,221
19,27,63,59,43,48,259
16,26,61,56,41,55,255
0,37,62,72,42,0,213
50,66,191,196,155,170,828
33,47,114,123,101,102,520
0,40,72,78,39,0,229
42,67,169,185,153,165,781
16,18,52,50,48,49,233
29,43,96,103,94,94,459
0,37,63,65,41,0,206
44,59,168,170,139,141,721
23,29,76,76,63,77,344
53,72,156,166,145,146,738
49,74,168,178,150,162,781
1,34,69,70,38,6,218
0,36,64,67,40,0,207
48,58,164,182,164,161,777
48,52,151,149,121,141,662
35,48,113,115,110,111,532
27,53,134,129,106,97,546
7,35,61,72,44,23,242
36,53,137,151,132,131,640
49,64,157,153,122,132,677
36,41,117,127,99,101,521
0,36,54,62,40,0,192
36,44,129,131,112,129,581
55,73,204,205,167,153,857
17,26,61,66,56,53,279
18,29,60,71,46,51,275
22,33,88,89,63,74,369
22,33,78,83,74,73,363
48,67,178,180,161,164,798
48,73,187,186,160,182,836
14,15,37,45,40,44,195
51,62,172,171,151,161,768
52,66,193,198,164,171,844
20,26,66,65,49,58,284
18,25,60,61,50,57,271
14,22,47,57,46,45,231
44,62,162,180,151,154,753
54,65,193,188,161,176,837
13,17,40,50,41,47,208
42,63,175,171,148,158,757
40,55,136,146,136,145,658
11,16,32,40,35,40,174
15,19,43,39,37,40,193
15,22,50,57,53,49,246
21,28,67,71,47,61,295
16,19,44,55,51,45,230
20,26,66,73,45,56,286
46,62,196,200,179,186,869
52,73,191,184,169,168,837
14,25,57,63,39,44,242
45,58,168,185,154,153,763
43,63,157,167,143,145,718
47,74,200,192,174,192,879
50,63,183,183,162,177,818
16,20,50,55,40,41,222
10,17,50,56,38,41,212
15,19,46,58,48,43,229
19,31,60,60,50,51,271
44,58,167,185,154,153,761
18,26,70,70,46,51,281
18,26,70,70,46,51,281
33,47,112,117,99,108,516
44,67,177,184,155,167,794
59,72,207,201,170,166,875
11,18,45,50,35,39,198
16,29,66,66,42,49,268
12,18,44,58,47,43,222
55,73,187,191,158,164,828
17,18,58,60,42,47,242
50,74,198,207,175,164,868
26,50,119,122,110,114,541
40,50,134,142,121,141,628
18,22,46,53,40,43,222
56,76,180,180,162,167,821
49,76,177,174,152,173,801
48,66,180,195,169,187,845
50,65,199,200,160,177,851
47,68,181,180,155,168,799
54,72,190,205,171,166,858
17,28,63,69,49,49,275
48,72,201,197,165,178,861
53,74,191,193,166,161,838
46,63,165,165,152,158,749
35,53,103,124,102,102,519
48,70,187,202,168,163,838
16,21,49,58,46,45,235
28,41,111,110,98,98,486
54,75,172,178,165,185,829
49,66,197,194,171,191,868
17,25,57,65,52,54,270
50,69,193,204,178,193,887
17,21,48,59,47,51,243
12,18,43,57,44,43,217
48,63,163,171,147,156,748
47,77,193,192,173,183,865
51,67,176,194,155,155,798
22,34,86,96,86,73,397
18,25,51,58,45,55,252
51,66,180,182,165,167,811
47,65,163,172,144,153,744
50,66,199,195,167,179,856
48,70,198,194,161,170,841
9,17,41,50,41,36,194
12,20,42,48,38,46,206
14,20,58,59,42,46,239
17,21,52,61,50,54,255
12,17,44,51,38,41,203
48,67,190,176,155,163,799
19,25,63,72,50,54,283
28,39,113,110,88,96,474
52,71,177,189,167,171,827
13,20,43,49,40,41,206
51,65,184,182,161,178,821
19,23,62,62,46,51,263
11,20,43,53,46,44,217
49,69,183,192,161,170,824
49,71,193,190,161,157,821
15,24,59,69,45,46,258
35,39,98,108,97,94,471
25,35,101,116,88,84,449
16,21,50,53,39,37,216
17,22,44,50,38,43,214
47,59,139,142,128,107,622
54,66,176,190,161,170,817
39,51,133,133,122,127,605
19,26,68,76,70,71,330
12,20,50,57,44,47,230
16,29,61,67,42,45,260
16,19,53,57,41,47,233
49,71,178,180,156,173,807
29,45,121,132,114,120,561
47,68,191,189,165,172,832
51,76,199,193,158,171,848
44,60,156,159,132,145,696
44,59,164,168,144,149,728
50,71,186,187,160,166,820
48,65,193,180,164,180,830
45,56,156,171,149,159,736
49,63,180,185,169,178,824
14,22,44,52,46,46,224
11,15,40,42,36,35,179
49,70,182,184,149,169,803
50,74,183,184,155,178,824
52,72,206,204,153,181,868
54,71,183,196,169,184,857
51,71,176,173,160,157,788
43,78,202,198,158,167,846
50,63,182,175,152,159,781
41,63,167,179,147,158,755
17,25,70,59,45,57,273
39,57,132,150,133,141,652
56,70,199,198,174,170,867
19,23,58,60,37,41,238
11,17,38,45,37,42,190
16,18,41,49,37,37,198
47,66,179,173,157,160,782
47,68,181,190,170,171,827
47,68,175,179,155,155,779
46,62,172,177,159,164,780
49,80,201,195,166,174,865
50,71,195,200,175,183,874
45,70,177,193,163,167,815
54,78,195,192,168,167,854
11,19,40,40,41,31,182
11,17,49,47,39,40,203
47,65,186,188,155,173,814
51,71,188,198,162,177,847
12,18,45,57,46,46,224
51,77,182,186,170,169,835
49,73,185,189,161,163,820
54,73,185,191,169,182,854
51,75,202,192,156,173,849
11,18,51,47,38,37,202
41,61,168,167,147,148,732
12,21,47,52,42,50,224
44,71,191,190,165,158,819
49,71,184,186,161,158,809
14,20,46,47,40,53,220
51,73,177,186,166,170,823
50,66,182,185,156,168,807
44,68,197,193,173,172,847
53,70,191,189,165,173,841
48,74,191,188,156,165,822
13,21,53,55,44,41,227
54,79,191,193,170,178,865
56,76,201,192,163,162,850
45,72,185,175,158,169,804
47,68,180,178,161,165,799
48,74,195,206,173,179,875
54,72,164,177,158,185,810
51,72,195,201,176,183,878
46,71,179,189,155,173,813
45,67,191,194,164,163,824
10,14,43,48,41,43,199
54,75,197,200,165,163,854
46,73,186,198,173,169,845
51,64,183,190,163,173,824
43,69,192,188,156,156,804
11,21,46,47,43,40,208
49,61,175,195,180,175,835
11,19,44,47,38,45,204
13,19,46,53,45,40,216
64,77,190,190,154,175,850
36,47,125,138,118,115,579
47,61,177,182,163,152,782
33,53,133,129,116,125,589
14,21,62,62,49,54,262
21,27,69,67,69,72,325
14,41,108,93,61,62,379
36,45,120,129,114,120,564
35,55,136,132,119,132,609
47,69,184,168,136,146,750
37,50,131,128,105,137,588
35,54,143,134,112,123,601
40,51,141,151,137,140,660
30,49,131,129,117,137,593
9,13,41,39,26,30,158
20,38,112,104,76,54,404
17,30,104,88,63,53,355
21,35,98,91,77,101,423
23,58,167,174,120,104,646
4,4,4,2,0,5,19
35,54,158,165,129,122,663
41,60,153,155,120,130,659
29,38,112,106,98,102,485
28,36,101,111,104,109,489
49,61,158,160,143,139,710
0,38,56,56,31,0,181
50,65,184,191,174,176,840
46,59,161,165,144,135,710
34,47,125,129,111,120,566
36,46,118,132,112,109,553
39,46,149,145,122,129,630
26,33,95,115,94,85,448
38,56,140,130,116,114,594
45,57,156,155,127,136,676
31,39,120,130,110,117,547
2,2,7,7,3,1,22
43,60,152,139,128,129,651
18,28,79,76,52,60,313
21,30,92,91,76,85,395
26,30,90,99,78,80,403
24,28,81,80,77,80,370
4,2,7,6,2,6,27
37,46,142,143,118,116,602
47,51,157,162,135,147,699
33,41,111,113,94,102,494
31,42,133,142,111,115,574
34,48,122,121,101,106,532
24,41,94,92,75,95,421
21,38,94,87,81,68,389
29,40,121,109,90,105,494
44,50,146,143,129,130,642
30,45,122,106,93,110,506
27,38,107,110,95,99,476
34,42,124,138,105,112,555
27,34,113,102,89,95,460
38,48,134,137,121,123,601
31,42,120,115,105,111,524
45,58,156,167,153,149,728
45,61,151,154,137,128,676
37,47,116,132,119,116,567
43,58,160,150,133,138,682
40,55,158,160,135,123,671
3,3,3,1,0,2,12
13,24,55,58,58,53,261
43,47,136,136,109,123,594
14,21,47,61,53,62,258
42,58,143,166,157,136,702
32,50,137,135,118,117,589
45,61,166,155,133,148,708
46,63,158,156,138,151,712
45,61,164,183,156,154,763
26,37,92,104,90,84,433
44,67,184,186,162,168,811
30,37,108,113,97,97,482
40,59,181,183,155,157,775
28,36,101,114,102,87,468
15,27,82,83,66,69,342
21,34,93,91,79,89,407
41,49,154,136,126,134,640
29,47,120,121,114,98,529
36,58,147,145,119,131,636
35,50,135,138,124,121,603
36,55,135,119,117,111,573
3,3,2,3,3,5,19
24,35,72,77,79,73,360
38,55,147,144,125,129,638
45,61,179,165,136,147,733
35,50,121,117,96,98,517
38,50,160,167,146,130,691
27,39,88,95,93,99,441
46,61,172,183,156,163,781
3,2,3,7,8,4,27
43,59,172,177,146,148,745
45,57,150,138,126,124,640
40,46,131,116,101,109,543
41,52,154,164,133,119,663
40,52,140,156,129,120,637
48,57,170,170,141,148,734
43,52,141,146,128,134,644
51,62,165,155,126,134,693
26,40,100,94,77,87,424
31,43,105,97,82,93,451
49,51,155,161,134,129,679
35,49,152,147,124,116,623
26,38,99,84,76,96,419
39,63,157,162,135,135,691
49,63,169,185,159,169,794
20,43,90,99,92,71,415
14,19,53,58,53,65,262
41,52,171,162,133,140,699
40,56,149,162,144,131,682
15,15,46,54,45,55,230
44,52,138,137,112,122,605
26,29,87,93,81,86,402
24,32,83,87,76,57,359
28,29,97,97,76,82,409
49,64,191,199,169,188,860
53,75,185,179,146,147,785
53,63,177,192,162,167,814
0,33,68,65,37,0,203
40,55,127,133,118,120,593
34,49,120,130,116,108,557
17,32,66,62,74,67,318
51,73,200,187,148,157,816
54,69,169,181,169,163,805
19,32,75,80,68,74,348
52,70,181,191,159,172,825
44,60,171,180,161,155,771
30,44,101,93,95,99,462
47,67,184,195,159,169,821
45,64,179,182,167,176,813
45,66,171,189,160,160,791
0,37,58,65,37,0,197
49,66,174,184,153,147,773
52,65,187,201,163,178,846
37,51,135,155,145,126,649
46,63,170,180,163,154,776
46,56,174,175,157,168,776
0,41,58,63,36,0,198
40,52,121,128,103,113,557
42,57,155,174,153,159,740
0,36,57,61,36,0,190
53,71,180,167,155,166,792
44,72,185,184,156,171,812
46,61,160,169,157,152,745
53,69,167,184,169,168,810
40,55,152,161,127,126,661
42,59,154,167,144,141,707
54,73,178,193,172,174,844
53,69,173,175,153,153,776
41,58,155,145,138,138,675
0,46,64,67,35,0,212
46,64,171,167,149,156,753
40,67,184,189,169,168,817
0,36,61,65,45,0,207
50,77,192,206,158,178,861
46,70,164,184,158,163,785
39,57,139,148,127,142,652
48,75,186,179,158,165,811
55,73,176,173,162,177,816
0,44,62,72,38,0,216
42,57,148,148,143,161,699
0,38,75,68,35,0,216
48,60,166,172,139,152,737
0,37,64,63,33,0,197
39,52,140,143,116,134,624
46,62,178,192,169,167,814
46,62,160,162,153,145,728
55,74,192,193,164,164,842
42,52,141,162,136,130,663
55,74,183,179,160,175,826
48,68,187,188,168,165,824
41,53,144,148,139,144,669
0,39,60,65,38,0,202
48,63,171,171,149,161,763
0,38,61,61,35,0,195
48,62,155,165,151,152,733
0,36,60,60,34,0,190
0,43,65,69,37,0,214
47,68,186,183,149,171,804
49,66,181,183,153,181,813
40,58,150,163,151,158,720
45,67,157,161,145,153,728
44,67,177,187,155,152,782
42,56,140,132,116,109,595
48,63,170,171,149,161,762
41,51,146,162,138,142,680
0,0,0,1,1,0,2
54,70,193,201,160,177,855
26,30,93,92,86,77,404
32,46,112,119,106,112,527
41,61,161,151,127,134,675
49,71,175,173,145,147,760
51,69,186,185,162,165,818
56,125,276,296,224,265,1242
39,59,142,139,135,132,646
39,53,133,138,121,124,608
36,45,137,140,118,119,595
17,28,72,65,63,63,308
46,66,186,185,142,163,788
17,21,67,70,58,68,301
17,25,59,56,50,64,271
33,44,115,112,102,121,527
38,51,142,157,142,140,670
35,47,143,136,121,126,608
36,48,139,131,110,122,586
44,59,174,174,150,160,761
47,65,175,171,161,174,793
43,62,161,162,136,134,698
36,50,133,122,100,118,559
39,52,141,138,119,135,624
35,43,142,140,131,138,629
34,54,143,146,129,127,633
30,35,110,108,105,95,483
43,63,170,151,125,133,685
35,48,135,141,107,113,579
41,55,132,132,126,119,605
31,47,134,138,128,132,610
41,53,151,144,126,131,646
34,47,133,121,103,104,542
17,21,56,59,50,51,254
42,56,163,149,117,117,644
31,48,130,134,109,112,564
22,40,88,106,96,85,437
48,63,178,191,173,166,819
28,42,102,100,95,97,464
51,61,162,146,142,148,710
42,63,165,170,139,147,726
44,58,150,142,130,128,652
31,43,107,112,103,97,493
22,25,85,88,86,91,397
26,40,108,110,83,81,448
30,32,94,85,77,93,411
24,31,80,74,65,76,350
20,25,77,81,75,88,366
27,36,91,89,69,76,388
27,36,91,89,69,76,388
20,42,90,73,62,77,364
21,22,72,67,61,67,310
22,28,70,78,63,57,318
2,3,2,1,1,2,11
15,17,52,59,59,67,269
20,34,75,64,65,56,314
42,53,157,147,133,127,659
5,4,1,1,1,0,12
33,46,132,113,98,109,531
25,41,83,88,85,81,403
23,45,91,95,90,98,442
22,39,77,81,78,73,370
17,24,66,64,61,61,293
45,60,150,144,129,142,670
23,35,107,121,96,80,462
31,45,124,131,113,112,556
28,38,106,97,99,110,478
20,30,77,60,47,51,285
35,52,121,119,103,94,524
17,26,64,71,63,72,313
0,0,0,1,1,3,5
17,15,57,55,42,46,232
17,23,69,67,62,62,300
46,64,173,182,156,147,768
40,61,174,174,149,164,762
44,59,153,144,130,141,671
25,26,94,90,69,59,363
22,35,76,52,45,58,288
22,35,76,52,45,58,288
48,66,191,202,177,191,875
51,64,168,173,159,159,774
57,68,180,169,154,162,790
51,70,188,191,151,153,804
46,60,165,169,152,158,750
43,56,162,174,147,146,728
45,64,196,204,168,180,857
51,71,181,172,157,168,800
45,68,191,188,170,165,827
32,43,121,134,117,116,563
48,61,169,183,161,171,793
28,47,131,135,104,109,554
40,58,139,146,139,131,653
35,51,150,156,130,138,660
14,30,70,74,72,74,334
44,52,139,139,127,129,630
43,62,165,164,134,145,713
26,36,110,121,97,115,505
29,50,121,125,105,101,531
32,49,115,119,106,117,538
32,49,115,119,106,117,538
42,57,158,146,113,124,640
38,61,151,147,129,137,663
25,34,91,93,88,85,416
25,30,78,84,62,65,344
39,44,135,127,120,132,597
39,49,144,142,128,140,642
38,59,151,141,127,125,641
39,53,140,147,132,144,655
53,66,191,197,159,168,834
46,54,163,169,162,171,765
24,32,96,111,83,82,428
28,32,91,91,93,112,447
48,62,177,188,157,151,783
52,66,178,185,163,166,810
23,30,87,92,86,97,415
33,44,116,116,102,101,512
34,40,113,123,108,100,518
22,34,104,102,89,103,454
51,69,185,181,162,157,805
38,51,136,139,129,120,613
41,54,162,148,121,129,655
48,64,174,167,149,145,747
30,40,102,109,108,100,489
31,44,131,130,90,101,527
44,58,163,163,137,148,713
42,57,153,150,133,130,665
17,36,95,97,73,85,403
38,55,142,131,119,124,609
27,37,86,94,81,100,425
34,60,139,137,117,123,610
36,64,160,140,115,126,641
41,58,147,137,123,130,636
43,65,178,177,153,151,767
37,58,158,161,122,141,677
45,70,180,183,165,172,815
44,71,177,183,167,168,810
53,66,172,184,160,162,797
51,62,182,185,159,160,799
32,56,135,126,121,130,600
49,70,192,184,162,169,826
53,71,187,180,151,163,805
45,59,159,165,156,158,742
41,61,164,165,143,158,732
44,52,149,162,143,149,699
56,61,183,196,161,168,825
44,61,159,160,146,155,725
43,54,143,149,140,156,685
49,72,175,190,166,162,814
48,68,175,167,143,149,750
39,50,141,151,136,148,665
55,69,185,177,159,160,805
42,63,179,187,153,168,792
39,57,156,152,134,145,683
43,52,153,162,146,140,696
34,41,120,123,119,119,556
38,44,143,136,109,130,600
39,48,132,133,107,117,576
44,64,171,172,154,158,763
49,66,178,177,152,158,780
46,65,184,180,162,168,805
40,58,140,142,133,153,666
39,40,124,135,117,114,569
47,66,183,183,161,161,801
50,68,193,193,159,167,830
51,71,199,200,171,167,859
46,66,176,171,146,149,754
46,66,176,171,146,149,754
44,60,165,172,149,152,742
48,63,178,182,154,159,784
48,68,176,183,154,163,792
55,65,173,184,154,145,776
47,69,180,171,140,148,755
45,65,171,178,147,173,779
48,63,187,180,159,174,811
31,39,115,128,108,106,527
50,71,190,189,173,169,842
30,46,112,109,102,98,497
57,74,186,200,167,174,858
52,69,191,189,162,156,819
50,64,165,178,148,152,757
49,65,175,187,172,170,818
39,57,145,161,132,122,656
54,71,191,186,171,182,855
53,77,179,190,163,166,828
50,71,187,179,158,153,798
53,65,185,179,159,177,818
45,70,175,179,168,161,798
22,27,77,69,59,67,321
48,64,174,181,155,156,778
52,67,188,180,159,177,823
59,71,194,184,155,180,843
52,73,183,184,154,172,818
47,75,186,200,170,150,828
52,72,190,187,159,168,828
40,63,167,164,147,163,744
42,60,146,160,148,166,722
39,62,160,156,147,165,729
49,68,186,181,162,160,806
49,66,178,168,140,144,745
44,66,192,174,158,170,804
46,60,162,165,143,160,736
44,60,163,175,151,159,752
46,68,173,174,153,159,773
36,49,131,142,120,116,594
44,64,185,192,169,157,811
42,54,164,170,157,161,748
41,67,163,166,147,153,737
45,63,172,179,153,152,764
38,52,137,143,130,125,625
41,56,137,141,132,131,638
19,20,61,66,45,45,256
57,69,187,185,162,160,820
413,1040,2113,2105,1661,2100,9432
35,40,117,119,104,125,540
40,50,123,135,113,116,577
42,62,179,185,152,170,790
41,61,153,152,134,143,684
41,51,137,159,139,141,668
40,57,149,157,142,143,688
43,57,152,165,152,145,714
39,59,142,145,117,131,633
44,60,142,150,131,145,672
39,59,148,158,131,140,675
40,58,144,163,136,147,688
41,62,147,150,127,143,670
46,64,166,165,151,153,745
21,18,70,76,52,64,301
32,47,117,116,99,98,509
32,45,111,112,104,102,506
34,45,126,126,101,114,546
25,40,107,116,91,88,467
25,38,125,126,104,119,537
36,45,116,119,108,126,550
25,31,91,98,94,98,437
53,64,180,177,151,159,784
48,67,172,177,151,164,779
44,69,179,176,150,152,770
38,45,150,162,135,139,669
45,62,163,155,146,163,734
38,61,158,166,141,142,706
25,45,103,120,113,96,502
28,42,111,104,92,90,467
44,61,185,185,158,159,792
51,71,194,183,159,175,833
47,61,180,178,157,164,787
16,31,68,63,71,77,326
49,72,183,183,163,166,816
47,66,176,178,156,171,794
41,64,189,178,151,156,779
52,72,178,178,148,167,795
48,66,167,193,177,176,827
49,74,203,187,168,182,863
44,66,185,187,158,156,796
37,57,159,175,154,152,734
47,59,171,171,167,174,789
489,1310,2620,2671,2173,2586,11849
355,791,1639,1634,1315,1595,7329
44,63,173,193,164,164,801
0,38,61,66,36,0,201
37,49,125,129,117,140,597
0,36,56,67,46,0,205
0,39,59,61,43,0,202
0,37,62,64,43,0,206
0,39,66,59,37,0,201
47,66,179,182,156,159,789
40,54,148,148,118,118,626
51,65,177,181,157,170,801
46,68,169,178,155,151,767
41,57,136,129,118,130,611
51,66,170,182,159,153,781
0,41,67,61,38,0,207
48,71,169,169,156,164,777
44,59,161,168,155,163,750
43,52,144,153,127,147,666
47,57,156,156,137,142,695
51,69,191,195,170,166,842
49,72,201,193,168,164,847
49,59,159,166,148,155,736
45,57,163,173,151,151,740
45,64,171,164,143,153,740
49,65,170,173,141,137,735
44,55,143,141,122,123,628
34,50,136,142,118,124,604
48,66,162,163,138,140,717
50,59,158,150,129,143,689
49,74,183,188,160,181,835
46,61,162,168,156,151,744
42,56,157,161,139,153,708
50,64,190,193,151,161,809
56,66,190,203,163,166,844
50,62,167,182,160,157,778
41,68,184,192,173,162,820
40,66,186,199,175,163,829
53,76,189,200,160,158,836
56,76,195,190,166,165,848
50,71,188,182,157,168,816
47,78,177,183,161,168,814
44,64,170,177,158,175,788
48,69,186,189,161,165,818
0,39,69,61,36,0,205
0,39,69,61,36,0,205
0,40,63,65,38,0,206
49,69,189,194,160,174,835
46,77,184,188,169,164,828
52,69,183,183,156,172,815
49,70,182,178,151,142,772
49,62,179,198,178,168,834
48,63,187,186,170,174,828
48,68,180,185,161,153,795
39,57,146,148,135,140,665
46,58,163,165,135,142,709
52,58,155,158,145,142,710
51,72,174,179,161,162,799
51,72,174,179,161,164,801
46,69,177,172,152,162,778
44,68,176,180,152,159,779
43,71,177,183,164,165,803
49,69,174,178,166,169,805
44,63,169,172,149,146,743
42,62,167,171,151,148,741
45,60,149,145,130,143,672
43,64,182,194,158,165,806
44,63,169,186,162,160,784
44,61,168,171,151,161,756
46,64,175,174,147,161,767
30,36,90,96,83,65,400
43,56,141,147,128,132,647
48,65,171,167,141,149,741
43,52,142,146,118,126,627
29,53,130,129,109,144,594
47,56,149,154,131,126,663
50,78,192,186,152,165,823
45,75,187,183,144,170,804
46,64,159,174,148,154,745
45,67,161,164,150,154,741
54,69,183,188,152,150,796
42,72,191,194,155,144,798
46,67,182,187,151,154,787
36,52,118,133,116,101,556
32,43,122,136,123,123,579
45,71,185,191,163,180,835
37,51,137,135,110,118,588
44,58,133,128,113,128,604
33,50,124,127,114,129,577
0,32,64,65,41,0,202
0,32,63,71,38,0,204
47,67,184,188,163,178,827
49,71,188,192,160,176,836
53,74,197,196,170,176,866
47,70,194,190,160,177,838
47,70,194,190,160,177,838
46,71,176,190,161,168,812
44,64,177,178,154,178,795
54,70,185,191,159,169,828
55,75,187,190,160,166,833
28,48,103,100,87,74,440
56,74,198,200,161,176,865
39,56,162,161,134,146,698
54,76,192,186,150,167,825
29,39,99,93,85,86,431
0,42,63,61,37,0,203
0,40,58,54,33,0,185
50,66,179,187,168,161,811
0,37,63,64,41,0,205
0,38,66,72,41,0,217
30,50,140,143,116,124,603
16,39,89,83,67,42,336
22,47,87,77,72,48,353
42,56,150,163,155,141,707
0,35,60,66,38,0,199
0,37,65,69,41,0,212
49,66,184,194,157,167,817
57,78,181,186,159,154,815
19,32,67,57,50,51,276
50,62,175,180,147,143,757
49,71,166,170,147,146,749
0,31,61,74,49,0,215
0,38,64,69,42,0,213
0,37,62,64,38,0,201
0,36,63,62,38,0,199
0,42,73,68,39,0,222
0,37,56,62,39,0,194
52,69,183,204,174,161,843
0,36,56,57,38,0,187
52,74,198,206,176,168,874
49,75,191,183,159,166,823
40,61,162,172,151,143,729
34,51,147,151,132,120,635
0,38,52,56,30,0,176
43,65,193,198,164,160,823
39,47,114,134,117,110,561
49,73,177,191,164,158,812
47,74,180,191,166,174,832
17,26,65,61,46,45,260
43,72,188,194,170,175,842
48,74,184,187,155,148,796
52,63,164,157,140,155,731
50,66,165,172,157,153,763
29,50,116,108,79,81,463
23,43,101,96,83,71,417
41,58,156,158,141,145,699
55,66,172,178,158,163,792
31,44,116,113,90,108,502
18,30,62,58,45,44,257
21,28,85,89,74,81,378
21,32,78,80,59,67,337
16,23,56,62,47,47,251
0,37,59,68,36,0,200
17,22,57,64,50,42,252
45,63,149,149,125,137,668
15,27,75,86,67,71,341
48,65,159,154,136,134,696
45,61,155,177,160,160,758
1,32,68,74,43,7,225
49,73,223,215,158,150,868
25,41,123,133,104,91,517
1,38,65,72,37,5,218
48,64,181,177,152,166,788
43,62,174,183,151,161,774
0,34,58,74,41,0,207
14,22,54,60,52,54,256
29,42,100,101,84,92,448
45,56,132,141,127,119,620
21,38,91,82,65,65,362
0,32,47,42,29,5,155
52,79,202,192,176,174,875
49,76,187,194,165,174,845
51,72,197,198,176,169,863
21,30,63,64,50,54,282
14,17,56,51,50,50,238
11,17,40,44,38,39,189
13,18,47,53,40,38,209
50,70,199,191,170,158,838
48,71,172,177,152,154,774
16,13,51,44,48,51,223
21,30,62,67,48,39,267
46,70,181,193,156,170,816
32,45,112,104,95,109,497
52,66,199,189,163,183,852
47,68,192,192,165,177,841
17,20,56,69,44,47,253
4,7,6,5,3,4,29
31,41,106,112,98,104,492
32,41,111,103,95,97,479
51,70,203,202,171,174,871
49,67,189,196,172,177,850
49,61,185,186,163,175,819
53,74,174,185,164,192,842
42,62,177,177,164,185,807
15,19,53,54,46,49,236
48,73,190,193,166,164,834
51,69,188,186,163,164,821
49,73,200,200,172,164,858
46,67,200,198,170,179,860
54,77,205,201,159,158,854
55,69,192,193,168,173,850
49,74,191,181,149,177,821
14,20,49,53,43,47,226
49,73,187,184,168,177,838
44,63,162,157,129,142,697
45,57,165,163,143,158,731
45,65,183,197,174,173,837
43,55,161,174,150,156,739
11,22,51,54,45,42,225
49,79,191,190,155,175,839
11,14,43,51,48,42,209
52,69,197,198,160,173,849
53,76,199,197,161,179,865
48,61,175,192,171,186,833
58,63,183,203,175,161,843
9,17,36,49,44,37,192
51,75,182,195,155,183,841
10,17,41,47,39,37,191
13,21,52,55,39,45,225
11,18,47,57,44,39,216
12,21,42,45,36,39,195
13,20,49,46,35,44,207
36,48,117,124,112,124,561
48,81,196,202,177,182,886
27,48,124,141,121,116,577
47,62,166,171,147,151,744
52,66,193,205,173,184,873
46,74,187,191,165,171,834
51,72,194,198,161,158,834
43,69,179,180,163,168,802
51,71,188,198,162,177,847
28,34,96,98,87,80,423
7,10,39,42,37,34,169
49,65,186,189,145,139,773
47,70,194,198,174,185,868
57,74,193,189,160,177,850
42,71,187,184,156,152,792
47,75,171,171,142,152,758
49,72,178,171,167,176,813
13,16,34,44,43,40,190
13,23,48,40,43,37,204
48,67,179,191,161,164,810
11,20,41,42,34,35,183
36,57,150,148,124,134,649
15,19,45,50,46,39,214
12,20,46,41,37,42,198
46,68,188,192,170,186,850
30,37,96,96,86,87,432
56,68,189,176,157,164,810
47,74,169,160,153,166,769
41,65,162,180,157,138,743
51,65,183,174,158,164,795
46,54,159,172,162,159,752
46,64,166,173,154,157,760
29,45,106,121,111,101,513
32,48,130,122,102,104,538
44,64,162,176,147,150,743
41,63,167,164,144,148,727
13,14,46,53,31,37,194
21,30,79,78,59,61,328
18,26,65,72,68,66,315
16,42,115,123,77,66,439
23,35,112,109,72,47,398
43,60,169,163,151,160,746
43,66,160,153,136,147,705
39,52,149,152,144,148,684
8,14,29,39,33,34,157
20,45,116,105,62,53,401
13,23,57,56,44,34,227
27,54,163,163,121,95,623
21,31,80,87,77,99,395
8,11,16,11,14,16,76
29,28,98,98,88,89,430
44,62,156,145,125,131,663
2,2,3,4,5,5,21
53,56,145,154,136,138,682
3,1,5,5,6,2,22
38,50,132,121,107,106,554
0,1,2,3,1,0,7
0,26,40,39,29,0,134
0,34,51,59,35,0,179
29,47,133,135,103,108,555
34,59,165,166,145,170,739
33,43,109,101,85,98,469
30,40,101,100,81,108,460
50,60,174,164,149,161,758
26,32,91,79,60,71,359
20,37,90,95,89,102,433
45,58,143,144,131,139,660
51,76,193,197,166,179,862
10,19,48,51,39,49,216
21,25,71,76,58,60,311
20,36,85,90,86,77,394
45,61,173,185,155,141,760
40,58,166,171,144,153,732
33,47,124,113,92,103,512
38,52,140,150,128,124,632
52,73,185,166,151,165,792
51,73,179,184,170,170,827
42,50,147,151,136,131,657
42,56,145,160,144,135,682
33,47,118,117,107,104,526
40,44,124,119,104,95,526
45,62,175,169,154,143,748
44,61,185,170,143,152,755
50,65,177,174,146,156,768
37,58,147,152,140,150,684
36,53,147,160,153,143,692
48,71,187,184,156,167,813
48,68,171,173,151,158,769
47,72,186,183,154,166,808
51,73,183,181,154,167,809
46,56,156,166,138,143,705
38,56,139,139,112,144,628
41,59,155,157,136,154,702
38,56,153,161,132,139,679
25,45,108,115,86,91,470
44,61,147,157,138,146,693
0,44,74,66,37,0,221
0,37,62,69,39,0,207
0,45,69,68,45,0,227
49,66,188,183,153,164,803
0,37,71,69,40,0,217
0,43,65,64,36,0,208
52,67,188,197,160,165,829
46,54,178,190,150,164,782
6,31,69,70,49,32,257
18,34,89,86,65,42,334
46,64,167,185,159,165,786
26,45,105,121,114,96,507
48,72,209,217,178,181,905
35,40,120,140,114,136,585
18,21,60,65,51,44,259
12,42,104,97,73,55,383
17,20,51,62,47,52,249
14,27,62,59,47,50,259
0,33,55,63,42,0,193
20,22,59,58,48,48,255
17,24,58,63,43,47,252
35,55,144,148,119,118,619
22,24,87,95,56,40,324
11,14,45,45,45,38,198
46,66,167,169,160,166,774
33,50,134,134,113,112,576
21,23,62,50,41,50,247
30,33,94,87,73,83,400
1,8,16,13,10,9,57
36,52,136,135,119,102,580
23,27,78,67,53,63,311
53,63,171,173,150,154,764
40,59,153,153,138,142,685
22,37,98,99,91,89,436
48,58,167,166,147,147,733
26,39,92,97,88,78,420
49,62,179,180,160,158,788
25,31,80,88,76,84,384
38,51,151,148,131,135,654
51,64,165,165,146,148,739
45,63,156,156,142,146,708
36,53,147,164,152,143,695
28,43,104,113,102,85,475
39,58,152,161,135,130,675
20,28,91,107,99,90,435
35,40,111,114,96,93,489
26,35,112,119,102,111,505
42,57,159,156,142,152,708
46,77,197,191,161,177,849
37,69,171,185,155,151,768
39,62,152,153,131,146,683
53,65,183,198,163,175,837
48,72,166,178,156,175,795
45,62,167,180,155,159,768
47,67,175,186,161,158,794
48,61,162,167,140,148,726
41,61,160,166,148,150,726
41,57,136,144,138,144,660
49,58,156,157,132,147,699
56,73,195,184,160,164,832
53,76,174,181,156,159,799
0,44,71,65,36,0,216
13,49,144,134,88,57,485
35,62,170,154,135,139,695
38,49,131,145,130,150,643
38,49,131,145,130,150,643
22,24,59,49,52,46,252
43,62,167,189,156,153,770
26,35,83,78,70,85,377
41,52,126,126,110,129,584
0,43,67,65,42,0,217
50,70,183,192,169,169,833
50,61,158,160,136,137,702
52,69,189,194,166,183,853
51,73,196,193,155,171,839
47,62,173,184,149,155,770
49,73,181,186,168,186,843
54,58,179,179,149,152,771
20,27,60,72,73,68,320
13,18,69,71,55,46,272
19,30,81,77,70,78,355
46,64,169,170,148,163,760
24,41,113,116,108,118,520
19,24,63,73,66,64,309
21,31,66,60,61,65,304
28,28,86,94,85,67,388
55,71,187,189,157,180,839
45,67,171,170,150,151,754
48,59,179,180,142,158,766
30,30,94,96,83,79,412
40,57,162,155,125,142,681
46,69,180,181,161,150,787
48,65,186,197,167,168,831
37,58,147,152,140,150,684
29,45,136,117,101,132,560
34,45,114,108,96,107,504
42,59,155,140,128,148,672
45,56,154,161,142,137,695
52,59,172,176,156,165,780
19,24,59,62,48,53,265
20,23,53,58,49,41,244
33,44,121,124,106,112,540
52,60,155,160,138,147,712
50,64,187,188,162,154,805
43,63,155,142,119,125,647
31,49,144,135,125,126,610
34,46,137,160,132,135,644
34,51,144,149,135,131,644
37,61,154,157,138,138,685
19,25,61,66,49,55,275
38,52,146,137,119,118,610
45,54,144,126,106,114,589
18,22,59,63,54,55,271
41,48,142,154,142,151,678
0,1,10,11,9,7,38
49,68,182,181,156,164,800
13,17,42,51,37,39,199
29,41,116,128,124,123,561
36,42,129,141,123,129,600
36,49,136,136,119,132,608
42,55,145,142,126,138,648
42,55,145,142,126,138,648
22,26,77,79,68,70,342
39,58,147,145,131,139,659
40,52,135,135,123,122,607
44,62,154,146,118,123,647
25,37,111,121,112,115,521
30,47,120,121,97,109,524
19,31,70,75,72,61,328
42,55,156,162,149,144,708
45,58,162,165,140,144,714
20,23,51,52,40,32,218
17,21,64,69,52,64,287
21,22,84,94,73,67,361
19,29,80,85,78,83,374
48,69,189,196,165,158,825
46,69,184,194,154,148,795
46,69,185,197,154,150,801
38,51,138,137,123,126,613
8,28,65,89,70,50,310
50,62,171,167,146,140,736
40,62,152,159,137,155,705
22,26,87,100,84,89,408
36,46,124,125,101,113,545
46,69,180,179,148,163,785
17,22,58,64,62,72,295
21,25,68,86,74,83,357
26,38,97,94,75,78,408
2,4,3,6,8,10,33
42,55,159,153,143,146,698
27,44,103,115,95,81,465
35,40,105,117,105,110,512
27,46,104,120,111,96,504
3,2,0,5,7,6,23
7,8,9,13,13,10,60
35,43,128,126,113,133,578
2,2,2,1,1,2,10
49,65,168,187,152,152,773
46,62,167,160,145,156,736
13,16,40,37,36,39,181
6,7,7,6,2,3,31
2,2,3,7,8,5,27
4,2,2,3,4,9,24
23,34,94,93,75,81,400
42,48,148,140,125,136,639
18,27,91,84,62,78,360
17,22,63,51,50,69,272
27,40,98,103,91,85,444
45,76,187,183,143,154,788
42,60,151,146,127,135,661
52,78,189,179,165,184,847
21,28,83,96,75,57,360
22,31,79,75,50,50,307
17,26,61,70,67,53,294
11,14,45,45,45,38,198
25,33,88,85,80,78,389
15,23,60,64,50,59,271
25,46,110,115,96,93,485
3,2,6,6,5,10,32
14,37,84,74,72,66,347
3,3,5,4,4,5,24
20,32,90,94,82,74,392
22,25,72,82,84,82,367
17,26,78,83,85,74,363
20,26,72,70,53,69,310
27,34,102,113,85,79,440
41,50,148,147,134,127,647
3,3,3,2,3,8,22
16,29,55,59,47,48,254
8,8,19,17,18,19,89
38,50,133,132,121,122,596
51,56,170,175,149,166,767
44,60,158,155,126,137,680
44,64,176,170,150,171,775
23,30,85,94,81,80,393
47,68,182,193,167,166,823
46,64,173,180,168,170,801
52,70,197,197,166,172,854
50,70,200,200,160,162,842
15,39,113,125,77,65,434
17,23,59,63,64,55,281
59,73,194,196,174,188,884
37,58,140,139,132,139,645
