56,75,200,189,163,178,861
10,27,60,63,66,72,298
19,28,32,37,28,35,179
28,34,80,79,58,69,348
54,73,192,201,178,171,869
19,32,38,39,33,32,193
38,63,154,164,139,142,700
20,26,76,78,67,54,321
24,28,72,76,73,75,348
53,78,190,189,159,166,835
18,31,97,91,69,83,389
22,31,78,83,63,62,339
19,30,77,76,61,60,323
18,31,87,97,84,78,395
14,17,17,19,19,18,104
12,19,60,72,60,67,290
28,38,40,35,24,26,191
24,23,80,86,65,71,349
14,21,61,60,56,58,270
15,25,49,60,42,57,248
19,31,62,60,64,70,306
24,35,89,73,58,63,342
32,53,140,148,122,130,625
26,35,83,89,69,68,370
51,70,193,195,162,174,845
23,35,80,96,88,82,404
33,37,100,106,88,99,463
22,34,84,91,79,75,385
47,75,174,174,150,152,772
24,31,30,39,32,25,181
17,28,67,78,61,61,312
53,68,171,170,151,165,778
27,33,101,110,93,95,459
35,38,90,101,94,93,451
52,75,185,192,176,178,858
39,58,130,143,128,145,643
24,31,32,33,33,31,184
18,30,56,63,65,53,285
46,61,72,72,58,44,353
48,83,91,99,77,54,452
42,57,145,157,131,151,683
44,65,153,150,131,141,684
44,69,182,197,164,169,825
44,66,177,181,158,178,804
63,94,93,91,59,50,450
21,33,96,105,86,85,426
27,34,79,88,73,78,379
21,38,109,115,96,105,484
49,62,156,165,140,158,730
6,17,21,20,18,17,99
25,31,91,82,72,76,377
11,17,20,22,16,17,103
45,58,143,153,140,133,672
20,28,79,80,65,66,338
19,28,64,58,66,79,314
20,26,69,78,59,62,314
19,29,92,93,84,81,398
7,8,7,4,4,8,38
59,87,95,88,60,49,438
22,39,34,29,23,20,167
16,29,86,78,74,85,368
16,21,68,81,76,80,342
29,32,84,85,82,83,395
41,56,133,146,131,134,641
52,83,102,100,67,54,458
20,27,62,68,49,52,278
15,22,75,77,54,68,311
19,24,63,58,54,54,272
47,68,193,205,167,178,858
26,32,108,109,89,82,446
33,47,99,111,89,79,458
46,67,160,166,155,161,755
41,64,169,190,173,183,820
53,65,175,188,170,176,827
28,29,90,87,78,79,391
9,15,36,47,47,39,193
24,32,105,117,107,92,477
22,35,79,79,78,97,390
39,57,117,116,109,123,561
26,42,96,101,102,90,457
44,73,76,69,54,38,354
47,59,144,151,133,129,663
52,66,157,155,130,127,687
34,32,78,81,66,82,373
50,65,161,175,150,155,756
53,70,77,79,59,55,393
54,84,95,89,66,57,445
51,86,93,92,74,59,455
47,61,155,153,143,144,703
18,28,64,50,54,59,273
23,30,99,102,84,95,433
12,29,84,82,77,79,363
40,55,130,140,126,124,615
33,42,126,117,100,111,529
49,68,158,157,127,136,695
46,61,183,198,188,196,872
26,35,88,96,75,80,400
6,14,16,18,17,23,94
5,8,18,18,20,23,92
32,39,111,108,97,94,481
47,69,176,169,166,171,798
28,36,109,106,94,96,469
50,69,187,184,150,170,810
23,37,107,111,86,92,456
25,27,93,103,84,83,415
36,53,152,170,139,147,697
15,23,53,53,37,42,223
26,40,33,29,23,30,181
18,29,31,33,25,26,162
32,36,91,101,97,99,456
38,44,51,52,39,29,253
42,54,155,165,142,151,709
24,25,84,85,60,67,345
20,28,35,33,28,33,177
24,32,105,118,107,92,478
53,83,104,107,69,66,482
21,25,73,81,66,66,332
26,49,92,98,92,105,462
21,28,71,87,82,89,378
50,72,178,188,168,161,817
18,22,55,55,57,62,269
20,34,36,38,29,31,188
16,28,30,23,17,22,136
13,22,61,59,53,45,253
39,53,130,138,114,129,603
46,64,178,186,162,186,822
49,56,148,157,139,142,691
31,40,102,116,95,89,473
43,65,170,182,166,182,808
40,64,77,72,45,33,331
14,20,16,18,19,28,115
49,90,90,84,66,54,433
50,83,100,96,70,49,448
34,56,135,145,126,139,635
27,31,93,97,80,76,404
38,64,141,149,137,133,662
44,66,173,184,152,162,781
18,32,72,75,63,76,336
25,35,28,36,33,28,185
11,17,42,34,48,55,207
44,64,141,163,145,145,702
29,36,87,83,60,61,356
19,33,34,35,30,33,184
22,34,26,28,26,24,160
19,27,67,56,54,50,273
15,26,29,33,25,23,151
32,44,105,99,69,82,431
29,38,94,102,87,92,442
18,25,80,84,61,52,320
49,67,172,187,166,164,805
24,32,101,110,93,88,448
42,62,150,147,128,141,670
37,58,64,73,55,48,335
33,35,106,107,95,92,468
15,21,68,71,62,56,293
35,39,99,86,90,101,450
46,65,175,194,178,181,839
47,58,147,155,135,135,677
18,39,43,38,34,33,205
16,29,67,66,64,71,313
23,29,80,71,55,46,304
47,67,168,163,139,147,731
9,23,24,27,23,23,129
27,42,61,52,34,32,248
21,32,89,93,83,92,410
17,19,50,49,35,36,206
4,6,8,8,7,4,37
26,37,108,102,80,82,435
26,40,103,113,90,88,460
50,76,187,194,168,167,842
20,36,49,52,47,45,249
12,20,17,19,16,19,103
44,70,167,172,150,176,779
4,9,4,9,8,9,43
12,20,61,68,55,50,266
38,56,152,160,132,152,690
25,30,67,78,77,78,355
15,29,87,95,83,81,390
46,67,161,156,126,140,696
18,33,78,67,47,48,291
35,50,115,132,112,118,562
10,22,75,79,79,86,351
8,7,9,9,9,11,53
48,85,86,95,85,55,454
18,29,63,60,57,64,291
24,32,90,97,68,82,393
51,63,178,194,167,163,816
54,75,183,192,166,166,836
40,54,133,158,140,148,673
6,9,6,7,7,12,47
12,22,56,68,59,48,265
33,33,110,104,84,81,445
16,14,41,57,54,42,224
55,74,180,195,168,158,830
27,30,95,100,88,85,425
25,33,78,87,73,78,374
54,83,99,96,66,51,449
54,84,95,88,66,57,444
47,80,94,83,52,37,393
27,38,42,48,35,36,226
16,29,28,29,23,24,149
25,36,29,37,35,28,190
22,35,93,113,98,95,456
19,36,84,91,80,74,384
5,7,19,18,16,28,93
13,29,25,21,20,11,119
16,32,38,37,26,29,178
18,31,85,85,78,96,393
19,23,60,64,56,55,277
40,59,154,170,151,144,718
40,57,142,157,138,156,690
27,31,72,81,75,79,365
8,16,23,28,22,22,119
23,29,90,97,81,84,404
25,35,33,37,33,35,198
16,29,32,37,31,28,173
14,21,53,54,55,61,258
44,64,172,183,159,158,780
16,26,61,54,46,40,243
48,64,157,192,175,173,809
42,65,176,186,156,169,794
27,42,98,101,83,88,439
18,36,91,101,92,97,435
21,30,36,38,25,15,165
35,40,102,102,95,103,477
29,39,107,109,96,95,475
23,38,99,107,100,98,465
42,69,132,129,113,109,594
19,28,32,28,23,31,161
18,19,62,75,79,92,345
16,26,60,66,62,61,291
14,18,53,51,52,48,236
27,41,101,93,69,80,411
29,40,95,99,87,90,440
16,20,20,24,14,18,112
36,57,132,120,104,120,569
52,65,180,194,166,164,821
47,72,173,193,174,170,829
42,63,150,159,136,142,692
60,75,80,84,69,48,416
19,31,29,28,25,27,159
7,10,30,31,23,25,126
18,26,83,82,53,60,322
19,28,25,23,18,18,131
18,28,83,83,83,91,386
50,73,78,77,61,55,394
16,22,71,66,52,56,283
22,40,85,84,77,89,397
30,29,81,88,89,82,399
13,18,18,15,17,16,97
40,58,140,152,135,125,650
38,58,143,155,141,148,683
53,88,90,87,65,47,430
45,65,188,187,152,162,799
22,32,31,33,27,26,171
24,30,97,101,75,76,403
22,34,95,99,91,93,434
3,4,9,8,6,11,41
27,29,31,33,28,27,175
25,39,103,104,93,108,472
13,17,17,16,12,12,87
30,52,117,120,104,103,526
48,74,181,181,168,179,831
21,36,40,38,34,18,187
32,41,118,125,107,108,531
33,42,125,116,98,109,523
28,32,94,99,79,81,413
36,48,128,126,99,106,543
41,59,143,156,121,122,642
23,37,31,32,32,18,173
24,38,102,97,84,91,436
47,68,177,180,163,172,807
49,72,180,183,151,157,792
42,73,154,159,138,117,683
25,42,101,113,107,123,511
4,6,7,12,13,11,53
17,32,34,34,29,31,177
23,35,36,38,28,23,183
33,46,110,107,93,97,486
21,37,89,88,73,82,390
27,48,96,94,76,97,438
20,31,25,25,30,30,161
50,70,183,198,171,166,838
26,41,102,110,101,93,473
40,64,62,72,59,48,345
28,34,30,30,33,33,188
47,60,163,168,165,179,782
19,27,30,35,33,25,169
34,58,134,140,115,127,608
43,59,162,163,146,150,723
20,27,64,62,66,79,318
9,18,51,48,46,51,223
34,60,128,125,110,103,560
34,41,98,88,86,95,442
11,19,51,70,54,57,262
39,61,148,142,114,113,617
51,86,86,87,69,58,437
25,39,105,105,95,99,468
8,9,28,27,30,31,133
39,48,114,124,108,101,534
15,21,31,28,19,22,136
8,19,53,50,38,39,207
51,69,159,159,131,129,698
44,66,155,151,133,143,692
38,58,133,120,104,120,573
19,29,30,33,32,20,163
51,86,81,75,66,45,404
36,54,128,130,103,107,558
7,8,9,8,6,3,41
9,19,61,58,41,47,235
26,39,101,98,65,83,412
37,60,127,123,120,143,610
17,30,90,86,71,74,368
47,65,163,156,144,159,734
28,37,111,119,99,96,490
39,74,86,85,72,65,421
37,68,138,146,138,128,655
42,59,174,189,160,158,782
51,81,92,91,71,47,433
26,30,75,83,69,72,355
47,70,187,195,164,167,830
35,61,129,139,125,125,614
26,38,88,97,93,86,428
42,66,165,176,164,165,778
52,70,181,185,165,170,823
49,73,186,185,154,160,807
28,36,82,85,71,75,377
14,29,32,33,31,23,162
49,66,147,141,123,136,662
32,41,124,125,99,93,514
44,61,155,166,144,163,733
5,9,10,7,3,8,42
22,40,107,104,72,86,431
19,30,69,83,78,69,348
44,58,143,152,132,150,679
22,34,34,32,31,23,176
11,26,29,29,23,29,147
14,18,21,25,27,25,130
24,33,27,23,23,19,149
46,63,157,157,139,146,708
26,36,83,88,87,83,403
46,66,151,159,138,127,687
20,37,102,96,80,84,419
31,34,88,91,89,90,423
27,34,70,71,72,83,357
21,36,79,73,72,69,350
42,66,165,177,164,164,778
52,67,192,206,176,167,860
3,3,3,5,4,14,32
40,62,161,175,162,161,761
43,66,74,87,70,51,391
39,58,154,157,147,150,705
33,52,125,136,113,110,569
19,30,64,70,69,76,328
21,33,24,29,26,20,153
4,3,6,9,5,2,29
20,30,64,66,68,68,316
16,19,16,14,16,18,99
21,33,76,81,71,70,352
15,32,73,84,68,70,342
30,41,46,43,37,26,223
24,33,81,84,69,67,358
18,27,79,81,75,77,357
31,35,100,105,85,88,444
25,36,101,113,96,88,459
20,26,72,69,54,60,301
23,29,83,93,83,89,400
27,32,69,83,70,64,345
20,27,82,94,84,84,391
4,7,7,4,1,2,25
5,6,13,17,15,15,71
11,11,10,12,12,6,62
20,36,89,88,73,69,375
26,30,74,65,56,71,322
47,67,176,180,157,169,796
19,27,76,84,72,74,352
14,19,20,26,22,17,118
12,19,32,34,33,26,156
38,58,145,155,143,136,675
37,63,166,178,158,154,756
23,31,44,52,43,44,237
35,56,131,145,124,118,609
46,60,153,154,123,127,663
44,60,166,174,155,166,765
35,65,67,74,57,45,343
42,59,159,172,135,147,714
47,68,140,151,135,128,669
2,4,3,4,4,3,20
37,54,142,149,137,132,651
10,15,18,19,24,28,114
44,68,142,131,115,124,624
34,56,125,145,130,129,619
23,28,71,71,64,59,316
22,34,85,93,82,76,392
30,39,100,111,97,91,468
25,38,47,44,28,24,206
37,55,145,146,134,154,671
6,16,33,28,34,50,167
40,54,149,167,144,141,695
16,20,19,22,20,19,116
44,58,161,169,143,140,715
36,58,142,149,117,123,625
7,15,38,31,43,56,190
25,44,101,105,98,99,472
45,60,139,136,119,133,632
21,25,77,86,65,73,347
45,63,145,156,125,127,661
49,69,74,75,59,57,383
45,63,148,162,132,133,683
42,60,158,155,138,147,700
17,28,74,77,73,85,354
42,64,146,144,120,126,642
46,60,136,143,125,126,636
35,42,124,125,106,114,546
3,3,2,4,3,3,18
10,24,28,30,20,19,131
28,42,44,50,34,34,232
9,19,61,57,39,44,229
3,3,3,4,3,9,25
13,21,58,63,59,57,271
27,37,124,128,110,105,531
20,27,28,27,27,25,154
6,9,12,16,11,6,60
8,9,18,21,19,21,96
1,2,4,3,3,7,20
18,29,30,29,29,25,160
43,74,168,165,152,148,750
18,34,86,86,77,74,375
18,29,84,88,84,94,397
23,35,37,38,31,26,190
45,68,181,178,148,149,769
16,25,30,28,24,20,143
27,37,32,33,22,19,170
11,20,46,44,45,61,227
44,57,158,166,149,146,720
7,5,4,7,7,8,38
37,53,130,151,135,137,643
5,9,15,16,12,19,76
49,64,178,181,163,175,810
27,38,89,90,91,102,437
7,10,12,13,15,6,63
41,62,133,130,110,119,595
10,17,18,20,15,17,97
20,24,68,79,63,64,318
45,70,164,164,152,159,754
22,37,34,32,28,20,173
20,30,73,70,67,60,320
26,42,100,95,85,97,445
47,63,167,177,164,156,774
4,7,4,2,2,3,22
14,25,28,30,24,16,137
25,38,39,43,32,30,207
20,29,100,112,80,78,419
16,26,26,31,29,16,144
10,11,28,28,27,38,142
47,68,132,132,116,138,633
47,61,164,174,151,136,733
1,4,3,4,3,9,24
22,35,40,39,32,24,192
44,66,138,132,117,130,627
42,60,159,172,137,150,720
54,69,175,185,161,156,800
12,23,25,28,18,18,124
8,14,12,14,11,12,71
15,20,19,20,15,11,100
47,63,167,178,153,168,776
22,38,34,32,22,40,188
7,10,9,11,10,15,62
6,5,7,5,5,7,35
35,48,110,114,99,107,513
45,65,171,176,157,164,778
47,63,145,136,115,141,647
46,63,187,179,164,180,819
45,69,139,145,121,123,642
43,61,140,148,142,148,682
45,58,151,154,124,125,657
37,52,133,145,120,128,615
35,48,116,114,100,112,525
23,35,85,82,69,78,372
57,86,109,101,69,58,480
46,67,156,159,139,155,722
20,22,57,57,53,42,251
37,53,129,139,127,138,623
45,68,181,177,147,149,767
10,15,13,22,19,15,94
17,28,76,77,65,40,303
11,17,14,16,14,11,83
38,63,144,159,146,157,707
22,28,32,30,26,31,169
0,2,3,3,4,7,19
43,58,138,163,148,146,696
37,58,56,57,48,25,281
53,74,174,173,160,181,815
1,1,0,2,3,3,10
29,35,99,95,99,107,464
29,41,102,113,97,102,484
45,63,163,170,144,148,733
23,31,25,32,27,24,162
24,36,93,96,88,70,407
38,61,139,143,127,117,625
53,74,183,166,148,161,785
21,26,82,89,81,80,379
42,52,133,149,135,144,655
9,12,9,11,11,16,68
39,57,144,148,130,128,646
35,63,135,137,121,117,608
43,67,167,177,158,147,759
4,7,3,1,1,4,20
38,61,155,164,149,170,737
42,62,179,184,163,167,797
44,73,160,160,143,152,732
47,66,155,164,150,148,730
2,3,3,3,3,4,18
2,1,2,2,1,4,12
19,30,25,32,26,28,160
14,14,41,49,45,46,209
34,54,128,136,119,103,574
44,63,164,167,142,161,741
5,4,8,6,1,4,28
40,64,162,162,140,136,704
28,38,41,42,37,40,226
46,60,167,165,158,159,755
31,40,110,118,99,90,488
40,56,141,154,136,147,674
9,16,11,8,11,10,65
42,63,167,178,148,146,744
5,10,13,10,11,8,57
60,104,100,109,84,66,523
42,55,148,169,139,138,691
20,30,86,96,81,90,403
38,61,137,145,120,134,635
23,38,90,88,76,87,402
50,74,178,164,157,168,791
8,21,25,30,21,17,122
38,66,141,147,112,122,626
28,35,78,86,65,65,357
13,29,79,81,75,67,344
45,64,133,140,119,125,626
13,19,22,35,29,25,143
41,66,147,158,128,127,667
43,65,168,179,163,173,791
13,18,19,23,18,27,118
49,71,175,171,139,135,740
22,41,103,106,91,100,463
41,56,121,122,115,120,575
15,27,24,23,14,11,114
48,74,167,170,137,149,745
19,26,30,30,24,23,152
24,33,97,102,84,79,419
57,77,95,102,74,67,472
4,8,11,12,7,11,53
42,59,176,182,150,158,767
47,56,147,154,134,161,699
1,3,1,0,2,2,9
20,28,72,83,59,63,325
27,42,72,76,61,56,334
26,26,83,88,68,71,362
54,89,106,92,68,63,472
29,43,49,51,44,38,254
25,38,40,41,34,27,205
26,43,46,46,50,42,253
21,32,72,75,79,77,356
87,148,173,160,124,100,792
3,5,3,2,1,1,15
4,2,5,3,4,6,24
32,43,109,110,104,103,501
29,43,54,50,46,41,263
52,84,105,101,86,59,487
31,45,91,101,93,101,462
24,39,102,112,92,95,464
24,26,80,80,64,78,352
53,82,103,106,77,75,496
23,39,45,42,33,32,214
5,8,6,7,7,7,40
25,37,38,41,44,41,226
0,3,3,4,2,4,16
19,28,31,38,35,35,186
22,32,40,34,28,33,189
78,143,156,150,122,99,748
22,33,70,69,64,75,333
19,34,33,33,34,27,180
25,42,44,39,29,33,212
30,40,54,50,38,32,244
5,6,5,4,3,2,25
24,33,48,46,38,37,226
23,30,77,80,65,71,346
28,34,108,98,74,75,417
7,11,17,17,16,12,80
5,6,9,8,8,11,47
26,39,85,93,88,72,403
30,45,93,93,74,67,402
28,38,92,93,78,106,435
25,34,42,44,34,38,217
20,33,31,31,26,28,169
17,29,63,69,53,53,284
13,19,19,21,15,25,112
49,78,92,87,71,63,440
7,9,15,11,10,11,63
24,27,68,79,65,74,337
4,2,2,3,4,3,18
48,77,89,85,69,61,429
3,8,11,12,11,11,56
33,50,65,53,43,46,290
32,43,101,98,89,87,450
31,40,46,45,36,39,237
39,64,61,61,48,34,307
46,76,92,83,61,59,417
82,141,167,158,122,98,768
25,32,66,56,52,82,313
1,2,1,2,3,0,9
34,38,102,105,90,93,462
23,29,84,91,75,71,373
32,35,44,46,43,37,237
15,31,93,98,80,74,391
21,30,67,75,72,68,333
23,35,103,119,94,97,471
29,38,108,109,87,83,454
20,35,46,44,41,47,233
22,31,34,29,28,32,176
22,44,99,99,90,90,444
24,40,44,43,35,34,220
30,42,90,93,87,73,415
33,63,69,72,56,45,338
22,41,105,105,78,92,443
25,35,53,61,54,42,270
22,41,86,72,46,65,332
15,19,33,30,30,35,162
34,40,45,39,43,41,242
6,7,35,32,23,22,125
3,8,8,5,7,12,43
15,20,56,62,53,42,248
52,98,121,110,75,70,526
16,32,30,35,30,28,171
17,29,29,38,32,31,176
0,3,4,4,2,6,19
86,154,173,156,109,91,769
5,9,6,4,5,3,32
0,1,2,3,2,3,11
15,25,23,27,16,12,118
30,43,57,54,44,37,265
84,128,151,144,99,80,686
6,11,15,16,9,8,65
66,115,124,102,71,60,538
56,88,102,93,68,66,473
27,42,84,94,93,80,420
19,35,26,29,26,29,164
25,33,69,73,72,77,349
27,42,38,36,39,40,222
84,134,156,154,121,93,742
34,39,105,116,111,121,526
1,1,2,2,3,3,12
2,4,3,4,3,2,18
14,18,24,21,17,17,111
24,34,88,92,79,79,396
18,29,72,84,86,76,365
33,60,115,132,121,111,572
7,12,10,6,3,6,44
30,41,43,47,40,40,241
31,29,87,93,81,89,410
42,60,70,74,69,65,380
25,40,42,41,35,30,213
24,33,37,42,29,25,190
46,84,103,101,76,66,476
8,12,8,2,6,7,43
1,1,2,4,2,2,12
24,31,35,37,35,37,199
19,39,80,68,62,67,335
1,2,1,3,2,4,13
34,44,125,127,107,109,546
78,140,161,156,115,92,742
28,41,91,93,91,88,432
0,2,3,3,2,4,14
2,2,3,3,4,11,25
4,3,6,9,4,4,30
24,30,30,34,27,36,181
13,18,43,42,26,28,170
16,21,30,24,14,8,113
3,3,4,0,0,1,11
49,76,82,81,68,56,412
19,35,35,35,28,30,182
19,35,41,41,31,33,200
32,40,41,40,34,42,229
1,4,5,1,2,3,16
27,43,88,97,96,98,449
6,10,8,2,6,7,39
10,21,23,26,19,15,114
24,32,28,28,21,22,155
27,35,64,64,68,63,321
10,11,22,26,17,15,101
10,14,22,18,18,26,108
40,44,86,88,86,83,427
1,6,6,3,3,5,24
6,4,4,7,7,8,36
30,47,64,58,41,47,287
45,50,111,118,110,113,547
5,6,8,7,8,11,45
30,33,103,110,88,97,461
28,40,47,52,46,40,253
27,37,95,106,97,90,452
2,2,3,1,2,3,13
31,44,96,101,87,81,440
27,41,40,38,34,35,215
46,75,88,79,63,56,407
20,31,36,40,28,28,183
45,76,78,71,65,55,390
30,42,41,41,41,31,226
33,42,47,45,37,37,241
30,39,44,41,35,27,216
14,17,23,20,16,17,107
92,148,166,153,110,92,761
30,37,49,44,45,43,248
19,35,65,60,60,61,300
19,30,66,62,57,64,298
14,21,16,24,24,18,117
39,64,71,70,71,59,374
1,0,4,8,8,6,27
15,20,54,56,49,46,240
28,39,105,113,100,101,486
27,41,104,85,76,90,423
40,56,147,149,126,139,657
14,19,56,51,49,50,239
48,74,167,163,143,144,739
5,5,6,4,3,12,35
7,12,28,33,26,33,139
5,15,36,41,30,39,166
30,40,112,116,93,103,494
27,35,100,96,96,85,439
22,32,68,68,74,64,328
30,36,94,103,85,82,430
47,63,158,160,135,154,717
22,43,107,109,93,101,475
36,49,106,121,103,114,529
25,33,90,95,101,103,447
24,37,93,97,90,90,431
5,5,10,11,9,4,44
47,73,162,157,149,149,737
34,42,121,123,107,109,536
79,115,162,149,126,135,766
5,6,4,3,4,2,24
19,34,77,77,66,70,343
27,41,86,87,77,89,407
30,46,121,127,120,126,570
15,23,64,59,54,67,282
27,31,79,84,74,68,363
49,60,169,177,139,150,744
35,52,133,151,139,139,649
41,56,151,159,140,146,693
29,46,108,116,105,112,516
42,61,162,166,137,146,714
42,58,153,158,150,161,722
38,57,141,144,135,144,659
44,69,159,156,136,147,711
87,140,156,142,111,101,737
1,2,3,0,0,0,6
36,48,116,110,109,117,536
28,35,78,81,82,85,389
2,3,5,5,5,3,23
96,148,170,156,114,86,770
38,51,131,142,125,122,609
37,50,119,114,118,137,575
10,17,49,52,39,46,213
39,61,161,166,144,153,724
42,58,146,147,129,137,659
35,63,132,133,121,120,604
11,18,39,32,25,20,145
45,54,135,135,121,132,622
23,30,81,85,80,87,386
24,36,100,116,84,89,449
6,8,8,13,10,11,56
30,39,91,87,73,74,394
38,55,136,136,106,110,581
36,48,140,151,128,137,640
42,56,144,134,121,137,634
8,6,35,38,34,39,160
42,63,162,154,142,147,710
7,5,4,8,9,3,36
47,64,158,158,137,138,702
28,41,107,111,92,97,476
29,43,107,115,117,126,537
42,51,134,143,117,131,618
51,73,170,167,154,158,773
30,43,109,109,104,99,494
22,28,70,67,63,65,315
6,10,14,17,15,10,72
3,4,7,6,4,5,29
47,54,162,164,140,149,716
1,1,0,5,4,2,13
42,54,150,150,126,124,646
19,25,76,79,55,59,313
37,50,115,111,97,109,519
30,43,121,131,111,127,563
24,33,77,75,58,68,335
34,51,147,157,129,144,662
32,44,124,135,114,98,547
9,16,41,48,46,43,203
30,41,92,99,93,96,451
1,0,1,2,2,0,6
38,53,146,156,127,128,648
55,68,156,158,145,160,742
41,60,164,160,142,150,717
37,53,130,134,120,127,601
24,31,94,101,88,101,439
35,55,118,127,104,115,554
14,24,54,51,52,43,238
37,62,140,128,118,117,602
36,58,143,122,110,135,604
8,6,19,14,7,17,71
85,140,150,130,105,87,697
16,22,55,49,56,57,255
40,59,130,137,125,156,647
50,69,167,168,158,171,783
1,3,4,4,2,4,18
17,21,50,64,54,62,268
27,33,91,100,86,99,436
1,5,4,5,7,11,33
4,3,4,4,3,7,25
32,49,113,117,93,107,511
39,58,148,148,133,134,660
51,71,159,164,144,149,738
43,60,134,150,140,156,683
37,51,120,114,96,105,523
37,53,139,148,134,141,652
37,50,114,110,97,107,515
32,28,78,81,80,77,376
47,62,141,123,115,129,617
27,46,103,108,89,78,451
5,6,9,7,6,11,44
36,57,140,140,119,120,612
47,63,152,146,127,140,675
43,63,170,165,145,149,735
26,34,94,101,101,113,469
32,46,108,112,102,111,511
11,18,57,54,50,62,252
8,7,28,32,21,26,122
24,35,102,102,84,107,454
23,40,106,94,73,79,415
49,62,165,156,127,132,691
31,48,120,135,117,124,575
47,68,166,177,158,154,770
25,47,89,77,79,85,402
46,58,154,164,146,146,714
31,45,126,132,107,120,561
6,4,4,1,1,7,23
45,57,119,109,115,129,574
54,68,169,176,153,160,780
82,129,162,151,118,101,743
39,53,131,148,133,133,637
32,43,110,120,124,114,543
3,5,3,3,4,2,20
3,2,4,4,4,1,18
41,57,136,132,115,131,612
34,42,114,130,114,131,565
13,27,51,43,32,28,194
27,40,90,82,79,76,394
50,69,162,171,154,159,765
30,47,94,96,74,71,412
45,73,166,163,146,158,751
3,3,10,14,7,6,43
95,145,159,138,124,100,761
32,47,136,154,136,136,641
37,47,124,134,108,105,555
20,31,30,35,32,34,182
6,9,7,3,5,3,33
29,42,49,53,43,40,256
28,40,45,52,45,44,254
13,21,19,15,16,10,94
0,47,74,67,45,0,233
0,1,1,1,1,0,4
0,45,76,74,49,0,244
0,43,72,71,51,0,237
0,39,69,75,48,0,231
0,40,64,64,41,0,209
0,11,19,27,23,0,80
0,25,43,39,21,0,128
0,42,64,64,41,0,211
0,29,47,47,31,0,154
0,39,64,70,42,0,215
0,16,31,38,22,0,107
0,5,10,10,7,0,32
0,7,16,20,11,0,54
0,40,63,68,43,0,214
0,2,3,2,2,0,9
0,38,71,70,44,0,223
0,2,5,3,1,0,11
0,39,59,67,42,0,207
0,39,55,62,45,0,201
0,43,72,75,46,0,236
0,1,3,1,0,0,5
0,36,51,55,34,0,176
0,46,67,72,46,0,231
0,44,64,66,39,0,213
0,2,4,8,5,0,19
0,38,54,67,44,0,203
0,27,48,51,31,0,157
0,37,60,70,44,0,211
0,2,2,1,1,0,6
0,42,68,72,47,0,229
0,34,56,67,40,0,197
0,0,1,1,0,0,2
0,31,48,56,39,0,174
0,23,38,40,25,0,126
0,36,50,55,34,0,175
0,41,62,59,39,0,201
0,44,62,62,42,0,210
0,41,62,59,38,0,200
0,30,44,40,27,0,141
0,42,58,66,37,0,203
0,41,63,67,41,0,212
0,38,59,66,43,0,206
0,7,14,16,11,0,48
0,48,69,77,48,0,242
0,41,56,59,38,0,194
0,47,63,64,42,0,216
0,36,51,54,33,0,174
0,45,60,68,46,0,219
0,41,60,65,42,0,208
0,47,63,64,42,0,216
0,44,62,64,41,0,211
0,14,23,27,18,0,82
0,14,18,18,13,0,63
0,41,61,68,42,0,212
0,37,56,61,38,0,192
0,21,33,23,11,0,88
0,46,59,63,42,0,210
0,8,10,10,7,0,35
0,35,52,38,21,0,146
0,39,60,67,42,0,208
0,44,63,66,44,0,217
0,12,14,8,6,0,40
0,12,22,30,17,0,81
0,21,35,37,22,0,115
0,40,60,72,49,0,221
0,9,10,13,12,0,44
0,3,3,5,4,0,15
0,34,46,53,38,0,171
0,16,26,20,9,0,71
0,38,56,61,38,0,193
0,2,3,4,2,0,11
25,33,34,39,31,35,197
47,76,191,185,168,174,841
26,27,92,91,87,82,405
22,32,33,35,33,22,177
40,65,149,155,137,142,688
38,61,162,170,152,168,751
49,73,190,186,153,174,825
51,57,163,172,153,160,756
53,68,178,178,149,163,789
33,59,119,123,108,111,553
25,37,35,38,33,29,197
53,76,189,200,169,175,862
15,21,30,28,20,22,136
40,60,154,161,125,123,663
43,65,161,172,151,162,754
53,76,189,200,169,175,862
56,71,182,195,179,179,862
50,73,182,192,162,160,819
43,69,176,172,141,157,758
15,26,29,29,32,32,163
23,37,37,44,40,26,207
22,30,31,32,32,31,178
45,81,186,174,149,153,788
24,32,26,21,18,18,139
59,77,184,175,156,159,810
42,65,152,170,153,157,739
56,70,192,204,188,181,891
53,66,183,195,156,177,830
29,32,35,40,38,35,209
43,58,149,153,139,147,689
51,83,199,201,178,185,897
32,44,109,114,105,102,506
52,66,183,187,160,153,801
20,30,32,33,32,31,178
24,33,34,39,39,39,208
35,48,131,138,130,117,599
47,69,151,155,136,138,696
43,67,169,170,147,168,764
48,71,153,164,134,141,711
33,36,95,101,89,86,440
20,30,30,29,24,34,167
23,38,93,101,95,105,455
44,66,167,172,143,149,741
22,30,32,33,31,30,178
46,63,161,168,150,126,714
41,63,151,165,140,150,710
23,30,25,22,19,21,140
44,66,167,172,143,147,739
51,71,182,181,150,149,784
42,68,165,177,151,165,768
59,79,181,185,170,177,851
45,68,169,183,163,164,792
46,65,177,173,141,159,761
23,32,32,32,36,35,190
51,69,177,180,170,153,800
48,60,184,185,150,181,808
51,66,177,199,177,171,841
28,35,86,85,66,62,362
24,37,35,38,33,29,196
52,65,185,183,165,169,819
53,67,188,188,166,183,845
24,32,35,42,31,29,193
51,77,191,188,159,168,834
45,68,165,164,142,147,731
51,65,167,181,148,147,759
49,73,181,188,162,167,820
42,60,129,138,124,133,626
3,4,3,3,2,6,21
50,57,175,184,171,170,807
52,73,176,188,167,171,827
52,74,187,181,160,170,824
51,66,188,191,180,183,859
44,75,176,178,167,162,802
55,73,192,199,170,171,860
36,60,144,151,134,144,669
47,64,164,169,153,154,751
23,35,97,106,102,108,471
58,62,195,208,186,180,889
23,36,102,113,90,81,445
41,64,148,161,137,135,686
39,62,161,167,144,146,719
54,70,181,191,185,175,856
48,73,172,185,153,148,779
29,38,33,33,33,33,199
43,66,143,159,141,151,703
51,70,194,204,180,162,861
48,63,168,170,155,160,764
23,34,37,44,33,35,206
16,25,63,63,41,43,251
33,49,93,91,84,84,434
45,70,168,167,146,147,743
28,38,63,62,63,60,314
43,66,154,168,137,131,699
43,64,156,153,135,133,684
43,61,156,164,138,152,714
37,61,148,150,118,130,644
25,44,59,65,45,42,280
50,72,171,175,157,156,781
20,30,82,89,85,78,384
34,51,122,131,103,99,540
42,60,158,162,134,146,702
38,67,173,176,150,159,763
58,70,184,196,178,178,864
23,30,78,82,67,60,340
36,69,165,173,148,146,737
50,72,186,199,163,177,847
40,66,169,176,148,167,766
49,63,168,169,150,161,760
41,59,138,149,135,144,666
44,71,152,160,127,141,695
21,30,42,48,43,36,220
48,70,178,179,157,178,810
36,53,137,137,134,133,630
46,68,164,164,159,170,771
16,30,40,32,29,24,171
28,33,99,104,80,76,420
52,69,176,197,178,178,850
53,69,187,198,179,178,864
52,72,181,178,173,176,832
23,36,35,41,32,31,198
46,61,149,159,141,144,700
56,70,182,174,163,174,819
19,28,33,35,29,38,182
20,28,34,32,30,22,166
41,67,168,172,156,162,766
56,72,192,196,181,175,872
25,33,29,35,36,29,187
54,68,199,200,170,189,880
43,53,164,172,158,166,756
48,72,184,187,180,190,861
42,62,180,187,166,170,807
46,69,181,187,176,192,851
40,60,145,149,129,124,647
1,41,60,61,41,4,208
47,61,183,198,182,183,854
50,66,177,197,175,166,831
27,60,146,155,129,112,629
45,65,186,186,159,180,821
16,24,73,78,71,77,339
1,2,6,3,1,2,15
2,1,6,7,5,9,30
54,68,181,183,162,171,819
49,71,184,207,189,179,879
48,71,178,190,169,186,842
46,70,182,202,187,180,867
24,27,93,85,62,61,352
47,66,180,185,164,174,816
55,69,188,201,173,180,866
50,66,188,200,173,178,855
54,76,196,198,165,180,869
53,74,190,192,178,179,866
51,69,191,194,170,173,848
47,69,186,191,169,186,848
48,72,187,195,169,183,854
49,73,179,175,161,171,808
49,73,180,176,161,171,810
47,69,186,191,169,186,848
55,69,191,197,179,180,871
50,69,185,191,170,168,833
50,75,195,197,171,175,863
53,71,191,202,174,163,854
57,76,194,183,164,174,848
48,72,190,193,159,179,841
53,82,218,212,178,173,916
50,66,186,210,189,181,882
51,76,195,201,168,182,873
44,66,180,182,160,174,806
43,68,198,204,175,197,885
53,68,185,196,179,197,878
54,75,198,196,166,163,852
47,68,195,203,168,170,851
52,76,190,195,173,177,863
49,67,193,209,183,175,876
50,69,191,205,177,197,889
47,62,182,187,166,172,816
21,41,40,36,32,43,213
22,27,33,30,21,21,154
30,47,62,56,40,45,280
28,37,43,45,46,43,242
24,33,30,38,36,34,195
31,48,102,108,99,103,491
15,30,62,70,52,62,291
31,46,49,47,39,43,255
28,34,94,102,75,72,405
25,32,42,44,37,36,216
28,33,95,98,90,100,444
32,37,119,123,110,106,527
33,52,138,149,141,154,667
54,72,184,185,163,168,826
29,33,102,114,91,97,466
51,62,165,168,149,153,748
29,38,115,118,92,106,498
46,62,159,169,156,156,748
46,69,165,165,153,166,764
50,61,184,199,174,185,853
45,52,159,169,142,162,729
418,1061,2163,2178,1842,2149,9811
39,49,139,149,138,141,655
44,67,179,171,154,154,769
19,34,92,99,88,85,417
20,25,78,76,68,62,329
51,71,188,198,173,170,851
54,68,196,187,152,175,832
20,26,72,76,63,63,320
35,47,134,125,97,111,549
27,41,92,93,86,87,426
51,70,179,178,154,165,797
23,29,70,60,62,64,308
44,51,126,125,128,138,612
50,74,197,194,157,169,841
40,57,166,168,152,153,736
48,65,169,175,154,150,761
22,29,86,89,78,72,376
334,784,1584,1565,1278,1561,7106
32,41,104,105,105,117,504
54,75,195,183,159,183,849
40,59,159,157,133,148,696
27,35,104,107,94,97,464
13,28,66,62,61,83,313
26,34,102,113,95,95,465
28,35,93,89,82,88,415
42,58,149,152,142,139,682
29,51,124,132,116,109,561
58,74,198,182,165,159,836
19,33,66,67,58,54,297
25,36,101,91,80,82,415
41,53,161,160,140,134,689
25,42,110,116,104,105,502
41,51,136,127,121,145,621
41,64,190,189,166,168,818
53,68,190,189,158,164,822
17,22,67,76,79,61,322
33,44,113,118,107,113,528
28,32,99,103,92,101,455
48,60,160,174,145,141,728
50,70,177,173,152,145,767
18,30,71,71,62,68,320
54,67,180,181,154,163,799
46,78,174,176,154,155,783
56,79,200,190,158,161,844
58,74,186,181,147,164,810
53,72,193,196,181,169,864
28,40,122,130,119,110,549
40,51,138,147,131,135,642
38,57,147,148,134,127,651
32,48,125,129,101,118,553
18,23,77,87,78,87,370
36,62,151,151,138,142,680
25,44,122,123,102,103,519
18,33,80,87,82,87,387
35,41,124,121,122,125,568
47,67,187,188,164,169,822
20,28,72,68,58,63,309
46,64,182,180,148,159,779
20,32,75,72,58,53,310
49,61,163,180,154,153,760
37,62,151,151,138,142,681
23,35,105,108,86,94,451
25,44,110,103,97,107,486
41,54,130,143,127,113,608
49,58,166,157,150,153,733
42,54,158,164,157,169,744
48,52,153,159,149,139,700
31,55,141,150,124,142,643
26,41,112,109,94,106,488
13,28,82,88,76,89,376
41,56,153,155,137,144,686
47,58,157,167,146,143,718
44,62,169,176,153,148,752
45,60,165,167,151,151,739
43,65,156,152,142,138,696
35,43,118,116,103,109,524
53,56,166,170,149,158,752
49,64,175,176,156,164,784
50,74,187,185,168,193,857
23,40,93,101,99,96,452
51,80,189,199,169,173,861
49,68,194,186,160,157,814
42,53,143,138,120,131,627
38,58,159,164,144,135,698
25,33,84,85,65,81,373
26,24,80,85,78,77,370
27,33,99,115,102,97,473
36,54,149,156,129,143,667
40,51,150,152,120,156,669
52,68,177,189,174,163,823
6,8,5,6,6,4,35
33,47,130,143,123,120,596
31,41,135,141,118,122,588
33,47,141,154,126,139,640
40,52,138,143,112,114,599
32,37,105,115,92,99,480
38,48,144,151,134,137,652
29,45,107,108,109,123,521
30,48,117,122,118,140,575
34,34,110,118,100,104,500
1,1,4,4,9,10,29
36,53,141,129,119,126,604
38,55,155,161,149,149,707
49,65,179,174,156,164,787
35,45,119,117,98,100,514
28,38,106,110,95,90,467
31,42,119,117,96,113,518
26,38,110,121,101,101,497
34,54,140,150,140,149,667
14,27,75,72,64,70,322
25,35,94,90,78,85,407
17,24,67,72,59,57,296
16,28,66,68,56,58,292
25,31,91,90,72,73,382
31,44,123,126,111,106,541
46,60,177,188,149,159,779
52,71,182,179,159,169,812
13,25,54,56,56,72,276
47,73,177,181,162,189,829
39,53,136,131,115,141,615
53,70,182,179,164,168,816
44,75,195,197,162,181,854
45,57,136,133,114,122,607
40,60,164,155,138,140,697
57,77,212,208,181,176,911
870,2369,4700,4781,3824,4668,21212
37,42,127,129,105,107,547
55,72,182,186,163,178,836
54,77,181,184,174,181,851
55,76,193,187,165,176,852
46,71,182,198,171,167,835
55,72,205,213,177,183,905
5,7,2,3,5,2,24
42,56,155,148,135,127,663
50,81,211,199,170,179,890
46,65,170,178,159,165,783
30,42,117,127,118,121,555
42,64,155,155,125,118,659
47,68,181,172,156,168,792
30,59,141,148,133,134,645
55,71,188,186,162,174,836
49,71,174,188,176,175,833
45,67,181,178,151,157,779
31,45,133,142,121,130,602
0,43,66,77,48,0,234
37,54,134,137,122,117,601
41,59,152,157,140,150,699
30,56,127,138,119,103,573
53,68,188,192,170,169,840
39,54,159,172,154,148,726
49,75,186,189,169,178,846
52,73,198,211,187,193,914
35,46,132,129,117,132,591
49,67,184,190,172,164,826
38,53,133,128,112,116,580
52,68,173,179,153,164,789
53,73,190,200,183,190,889
129,271,542,572,426,514,2454
27,49,125,125,117,124,567
52,68,192,192,174,183,861
42,55,143,147,134,138,659
41,62,175,169,152,166,765
35,55,132,132,121,124,599
29,49,129,126,101,109,543
52,68,171,178,154,163,786
51,67,183,183,170,188,842
14,17,52,62,62,57,264
53,70,192,189,162,158,824
45,72,177,180,149,160,783
48,70,200,203,164,165,850
47,77,187,194,169,186,860
39,53,137,120,113,127,589
46,64,177,174,142,151,754
43,62,173,169,158,168,773
53,68,185,185,161,174,826
48,67,186,202,184,164,851
54,77,189,191,174,170,855
0,41,61,64,41,0,207
51,75,183,167,148,156,780
43,67,191,198,174,177,850
38,57,167,177,153,146,738
40,56,134,142,126,125,623
16,53,94,98,68,47,376
47,66,177,181,154,169,794
52,70,180,185,160,173,820
40,51,134,137,118,122,602
31,44,109,122,107,111,524
44,62,158,161,139,153,717
30,38,111,120,115,122,536
33,44,101,113,107,113,511
31,54,137,142,122,125,611
49,82,178,172,156,160,797
42,52,141,134,120,130,619
51,70,174,167,141,150,753
58,71,213,203,160,157,862
38,58,152,136,127,151,662
53,73,193,195,175,187,876
48,67,178,176,158,172,799
35,47,143,149,131,151,656
53,59,133,140,120,125,630
53,65,174,179,157,146,774
0,51,73,77,50,0,251
51,73,188,196,180,182,870
24,33,42,41,39,40,219
42,48,124,127,116,118,575
62,81,205,215,178,191,932
33,37,43,46,37,44,240
0,44,76,87,45,0,252
35,44,46,53,47,46,271
45,63,161,176,140,143,728
2,44,62,77,45,14,244
0,50,71,85,53,0,259
32,40,45,55,48,44,264
36,38,115,118,107,118,532
38,51,132,133,116,128,598
40,51,146,141,120,143,641
46,70,182,189,156,169,812
44,61,170,172,140,152,739
12,60,86,97,64,10,329
30,42,51,44,39,40,246
58,79,170,172,151,154,784
33,56,136,133,104,97,559
0,48,69,81,40,0,238
28,46,49,48,45,51,267
34,37,45,47,41,38,242
36,45,44,47,53,47,272
41,63,180,179,159,163,785
47,71,174,175,149,175,791
49,65,163,172,153,153,755
32,49,129,132,119,116,577
71,115,145,139,101,86,657
27,36,55,56,53,57,284
22,60,103,102,68,46,401
30,47,49,51,42,37,256
38,67,135,137,118,114,609
33,46,42,48,46,42,257
35,48,48,50,46,48,275
48,64,191,186,160,171,820
48,62,169,176,153,153,761
0,49,68,92,60,0,269
98,142,168,152,128,117,805
36,41,49,49,45,45,265
34,47,132,141,118,126,598
49,63,169,177,146,150,754
45,58,160,180,156,146,745
56,67,162,181,154,169,789
38,50,131,149,131,129,628
51,64,174,179,150,148,766
0,41,65,74,42,0,222
46,60,164,171,153,145,739
53,73,193,197,175,175,866
44,53,146,142,126,146,657
47,69,184,179,146,163,788
34,45,48,53,44,39,263
34,47,47,52,49,41,270
0,49,72,76,40,0,237
31,43,47,49,50,52,272
47,63,161,174,141,145,731
34,49,48,47,46,46,270
20,55,88,106,69,47,385
9,45,71,88,53,14,280
38,62,157,165,142,166,730
24,41,95,95,82,73,410
32,46,49,61,51,46,285
36,42,42,42,42,39,243
41,55,141,152,135,137,661
53,67,192,197,166,145,820
34,51,133,138,123,142,621
32,54,142,147,137,144,656
49,66,169,172,161,164,781
47,63,165,178,150,158,761
31,43,122,126,110,117,549
56,84,92,86,65,73,456
45,57,155,169,144,152,722
53,69,183,191,155,161,812
49,65,163,172,153,153,755
14,25,55,65,55,46,260
32,63,101,117,77,42,432
43,61,117,135,117,119,592
25,45,49,45,41,40,245
53,67,176,185,163,163,807
38,48,135,153,130,134,638
8,44,76,77,45,6,256
31,48,53,48,43,38,261
47,68,184,201,174,166,840
45,69,172,180,153,162,781
36,44,80,78,62,73,373
46,65,170,177,151,154,763
49,68,183,184,148,166,798
13,55,79,77,53,31,308
38,54,133,139,107,112,583
47,70,195,196,156,160,824
39,38,44,42,41,43,247
42,58,157,161,144,170,732
0,59,77,74,41,0,251
56,68,187,195,168,169,843
0,45,67,79,49,0,240
35,46,45,48,49,52,275
33,38,44,50,44,43,252
43,55,144,159,153,143,697
35,40,117,122,116,130,560
0,52,71,84,50,0,257
0,49,64,71,43,0,227
31,45,47,52,41,37,253
36,40,40,44,39,42,241
0,51,71,80,47,0,249
58,72,203,207,174,183,897
34,45,117,128,110,110,544
0,54,75,84,49,0,262
59,70,181,189,164,173,836
19,23,60,62,55,55,274
25,40,112,120,104,110,511
0,48,66,82,45,0,241
50,63,178,181,152,152,776
34,42,69,74,52,55,326
47,63,167,172,144,158,751
44,70,185,198,171,169,837
0,45,72,93,57,0,267
0,51,78,87,48,0,264
50,69,180,184,152,171,806
42,62,160,157,131,141,693
31,46,118,128,107,127,557
34,63,114,131,115,107,564
9,47,73,87,51,19,286
40,57,130,137,126,130,620
54,60,158,164,156,153,745
38,52,131,131,115,113,580
0,53,71,76,49,0,249
39,54,134,134,116,129,606
50,69,189,206,175,168,857
34,45,41,49,43,39,251
28,36,35,51,49,44,243
41,48,74,76,69,72,380
32,41,73,68,65,75,354
59,69,181,195,162,178,844
54,74,193,192,163,171,847
27,25,28,37,32,28,177
50,69,178,179,149,156,781
61,81,192,203,177,168,882
35,44,44,50,45,49,267
36,38,46,54,49,46,269
26,32,39,39,30,30,196
48,58,166,187,170,169,798
60,80,199,202,180,180,901
25,35,42,40,40,41,223
54,78,168,175,164,158,797
38,60,146,145,134,144,667
24,34,36,42,35,28,199
27,32,29,43,35,35,201
29,38,44,51,46,43,251
37,41,74,66,51,63,332
28,36,44,44,38,44,234
36,46,46,53,46,47,274
53,76,193,194,173,197,886
53,72,180,200,182,193,880
38,45,41,44,45,41,254
51,68,185,186,160,163,813
48,66,163,168,154,148,747
50,73,192,178,150,173,816
63,79,187,202,181,168,880
33,45,44,47,40,37,246
26,35,40,40,32,37,210
31,36,40,48,46,45,246
37,47,46,47,39,42,258
50,67,184,186,160,163,810
33,40,41,48,39,38,239
33,40,42,49,39,38,241
41,50,129,133,115,109,577
59,74,192,208,175,184,892
62,81,181,190,161,180,855
29,31,37,29,27,30,183
38,37,50,49,45,48,267
26,34,35,36,34,47,212
54,78,193,202,168,181,876
36,48,47,41,43,39,254
54,73,196,204,179,174,880
38,60,119,131,114,103,565
41,58,139,152,135,140,665
30,35,39,38,38,40,220
48,71,188,190,156,171,824
48,69,190,199,175,171,852
52,70,189,211,188,186,896
62,71,181,205,177,186,882
59,82,187,184,157,168,837
54,73,184,193,169,176,849
35,37,52,52,47,47,270
57,72,187,207,185,191,899
52,68,181,201,175,182,859
49,66,176,186,164,169,810
32,40,112,116,102,116,518
54,69,185,200,170,177,855
31,40,44,49,44,35,243
36,44,112,119,103,105,519
58,77,183,203,173,178,872
60,79,197,208,191,205,940
34,47,43,47,41,41,253
49,71,186,198,178,200,882
34,39,45,46,49,47,260
28,38,39,37,39,49,230
47,64,170,183,156,159,779
64,84,190,200,180,193,911
53,70,168,189,165,177,822
30,38,96,98,80,97,439
32,36,44,52,46,48,258
59,76,185,198,177,163,858
51,67,180,186,156,161,801
55,68,188,191,165,174,841
52,79,193,198,176,204,902
28,37,39,46,33,35,218
29,38,33,32,30,34,196
33,36,48,55,46,36,254
32,36,47,47,46,45,253
29,34,37,39,36,37,212
51,71,190,203,182,175,872
38,43,50,51,47,46,275
37,45,110,115,104,90,501
57,72,197,208,175,174,883
28,33,32,45,41,40,219
63,79,187,204,183,169,885
36,39,41,47,46,42,251
26,29,36,43,35,30,199
55,73,200,200,166,186,880
62,77,200,202,167,192,900
28,31,40,44,49,47,239
33,48,101,104,98,104,488
28,43,103,112,96,90,472
27,38,42,46,37,42,232
30,31,35,37,38,39,210
40,60,147,151,137,132,667
54,74,185,192,174,176,855
36,49,147,153,132,121,638
28,36,65,70,63,63,325
27,34,36,37,40,28,202
40,46,44,50,47,44,271
36,42,44,43,43,41,249
59,70,189,189,158,167,832
38,49,131,132,115,127,592
60,77,184,198,171,193,883
55,69,186,193,174,190,867
49,70,182,179,155,159,794
46,63,156,161,147,174,747
55,69,183,180,173,189,849
47,70,189,198,173,162,839
46,69,170,174,163,182,804
55,67,181,188,169,216,876
31,34,37,44,34,43,223
22,39,40,39,32,27,199
49,70,181,182,162,166,810
49,64,185,197,171,168,834
53,74,193,195,168,189,872
51,75,192,204,176,193,891
51,74,189,195,159,174,842
49,69,183,182,175,161,819
45,77,190,184,158,162,816
49,71,177,182,160,176,815
28,37,58,62,49,41,275
40,58,142,149,126,131,646
53,79,197,212,181,187,909
30,40,38,45,44,35,232
23,26,30,39,32,29,179
24,29,37,41,34,38,203
51,75,191,186,162,168,833
54,72,193,202,179,174,874
46,65,164,174,157,173,779
41,66,176,182,166,176,807
55,73,193,187,171,196,875
51,69,198,215,182,189,904
52,73,180,196,178,173,852
56,75,191,198,174,171,865
24,35,30,30,25,32,176
27,39,31,36,29,27,189
50,70,183,189,165,172,829
49,72,185,189,174,186,855
26,35,37,42,41,45,226
56,76,197,201,183,191,904
56,76,193,186,167,161,839
51,74,202,202,168,184,881
53,74,195,198,169,172,861
25,38,39,41,32,27,202
43,66,167,172,153,162,763
29,36,41,49,44,50,249
54,75,199,214,177,180,899
52,75,199,197,157,161,841
32,38,38,43,39,41,231
53,81,193,195,175,177,874
52,73,182,184,164,179,834
50,76,196,191,170,191,874
51,69,190,195,168,163,836
51,63,170,185,168,163,800
29,36,34,40,38,33,210
57,70,188,190,181,195,881
59,75,204,209,172,178,897
50,73,191,195,175,176,860
55,75,185,184,170,172,841
55,72,196,204,176,184,887
50,69,198,197,170,193,877
50,71,199,216,182,189,907
49,69,179,188,181,189,855
51,67,183,192,164,171,828
30,39,41,45,38,35,228
56,77,193,185,171,195,877
55,71,200,206,175,188,895
47,70,183,192,166,172,830
47,68,188,194,168,175,840
22,33,32,32,36,38,193
51,64,182,187,173,173,830
31,36,38,42,39,39,225
30,39,41,42,41,35,228
51,71,181,181,167,180,831
37,60,136,138,126,129,626
50,71,177,186,154,178,816
46,70,143,142,124,124,649
19,28,71,67,53,48,286
26,40,96,87,67,79,395
21,26,34,31,30,31,173
40,56,132,134,111,108,581
41,63,142,151,135,125,657
45,70,171,168,143,155,752
42,63,135,139,119,119,617
41,64,133,130,110,119,597
50,71,158,163,142,128,712
42,64,146,145,122,127,646
17,27,27,35,29,16,151
40,68,73,59,42,42,324
26,41,37,38,32,40,214
31,37,94,105,92,88,447
47,77,104,103,79,62,472
3,3,4,2,4,7,23
64,103,148,149,130,134,728
44,59,159,159,137,145,703
27,45,103,102,94,101,472
29,46,110,110,90,103,488
46,62,163,164,148,155,738
0,43,66,67,45,0,221
47,70,194,198,174,176,859
45,62,173,172,147,139,738
30,45,124,126,106,116,547
39,44,119,123,126,154,605
43,50,141,155,144,132,665
25,24,86,104,102,98,439
40,43,128,134,114,129,588
40,59,162,165,142,133,701
35,46,118,132,107,122,560
7,6,2,7,6,4,32
35,56,145,159,141,133,669
22,28,83,85,67,62,347
23,26,85,98,87,88,407
24,35,79,84,84,86,392
24,38,106,100,78,89,435
2,1,3,3,2,7,18
37,57,153,155,132,133,667
46,64,174,173,138,135,730
30,40,112,122,90,90,484
37,56,135,127,109,115,579
31,46,118,124,111,108,538
24,38,103,104,89,96,454
18,30,90,96,81,79,394
37,42,119,116,100,117,531
44,62,150,150,138,149,693
37,40,110,121,106,97,511
34,37,123,128,107,91,520
34,44,117,127,118,130,570
29,43,112,116,84,91,475
39,52,133,146,139,141,650
33,44,110,121,104,113,525
50,66,166,151,130,146,709
43,58,164,171,151,141,728
38,41,127,143,127,115,591
45,61,168,163,135,143,715
38,61,167,160,131,131,688
5,4,3,5,6,6,29
9,20,63,68,53,59,272
35,56,148,144,118,129,630
16,21,56,60,56,58,267
47,59,168,175,151,146,746
37,51,141,143,136,147,655
54,56,168,159,131,133,701
45,61,162,160,135,140,703
45,67,158,170,153,157,750
20,33,94,108,95,103,453
55,71,193,183,168,172,842
29,43,106,111,98,96,483
48,58,169,183,157,164,779
30,42,118,116,103,111,520
23,36,93,94,76,82,404
24,41,95,98,90,93,441
44,58,150,145,135,150,682
31,49,112,122,125,122,561
40,54,146,146,122,144,652
38,54,142,154,140,141,669
34,53,143,130,116,119,595
3,2,1,4,4,4,18
22,32,67,78,80,79,358
44,55,147,149,130,144,669
40,59,162,173,154,151,739
29,45,111,125,98,96,504
42,61,175,168,156,164,766
35,38,107,106,98,101,485
50,66,191,191,161,163,822
2,4,4,6,7,12,35
45,64,179,167,157,161,773
42,61,154,168,136,135,696
40,47,129,138,120,116,590
47,60,166,164,146,152,735
29,42,135,144,119,132,601
44,62,170,171,149,157,753
38,58,141,138,137,140,652
51,68,168,169,139,138,733
32,42,117,118,96,94,499
27,40,110,104,83,91,455
45,57,164,164,142,165,737
42,44,138,143,131,121,619
32,40,117,111,95,98,493
48,65,176,168,154,157,768
46,64,169,167,156,171,773
24,34,91,99,80,94,422
19,26,63,61,47,41,257
44,61,172,175,150,154,756
47,63,166,151,129,154,710
17,20,59,53,48,49,246
41,57,151,153,137,145,684
28,36,100,102,84,72,422
19,38,97,93,76,85,408
28,39,102,88,90,89,436
57,69,195,203,177,173,874
54,64,172,177,155,161,783
51,82,187,186,166,181,853
0,44,70,77,49,0,240
30,48,124,149,131,121,603
35,52,141,147,124,118,617
23,26,68,76,64,75,332
56,72,201,203,175,177,884
46,71,185,202,172,164,840
18,31,81,91,80,70,371
47,70,187,188,163,171,826
43,67,170,188,166,168,802
34,39,103,106,91,93,466
50,77,187,197,179,188,878
44,70,175,191,170,180,830
47,66,178,182,155,165,793
0,41,64,78,50,0,233
51,74,187,190,157,161,820
52,71,189,192,166,174,844
42,50,152,158,134,152,688
38,61,175,187,160,157,778
43,68,187,197,162,169,826
0,44,69,76,49,0,238
36,47,118,136,119,128,584
46,68,165,184,172,172,807
0,46,67,75,44,0,232
55,68,183,180,160,172,818
48,69,189,196,173,186,861
47,63,168,186,163,172,799
49,68,184,190,171,174,836
44,56,143,168,142,143,696
46,62,159,170,152,153,742
58,74,202,188,160,172,854
48,67,179,188,160,173,815
42,62,158,175,151,147,735
0,51,77,78,45,0,251
41,69,177,177,147,145,756
48,71,184,204,177,177,861
0,42,65,68,44,0,219
56,83,193,194,177,189,892
49,66,182,191,165,175,828
45,58,150,164,139,137,693
47,76,187,204,177,171,862
57,89,195,197,178,200,916
0,57,80,81,49,0,267
42,64,164,176,152,154,752
0,43,64,80,50,0,237
45,59,164,175,160,154,757
0,43,69,84,46,0,242
41,50,142,150,132,131,646
48,75,194,207,177,172,873
39,70,167,174,149,160,759
53,65,191,202,172,196,879
44,56,151,160,144,137,692
55,68,193,192,168,186,862
51,78,184,194,165,182,854
43,57,156,156,143,126,681
0,50,68,84,49,0,251
48,66,171,171,147,155,758
0,46,65,73,47,0,231
46,56,150,161,146,147,706
0,44,66,66,41,0,217
0,53,76,74,45,0,248
48,70,183,182,165,172,820
44,73,185,189,176,177,844
45,59,163,158,145,146,716
43,70,166,172,148,159,758
57,71,189,201,166,171,855
37,55,138,128,113,141,612
48,66,170,170,147,155,756
44,55,146,157,148,151,701
0,1,2,3,1,0,7
56,73,186,197,181,190,883
23,33,97,98,85,90,426
32,44,134,141,121,119,591
49,57,165,172,139,152,734
50,65,173,182,158,161,789
55,72,196,189,173,182,867
60,110,265,249,213,234,1131
42,60,146,157,126,130,661
40,56,149,142,127,159,673
38,53,142,140,116,115,604
18,22,74,76,70,69,329
43,60,174,176,155,157,765
22,34,82,70,61,67,336
21,18,68,71,58,60,296
28,44,116,131,108,112,539
45,57,156,162,145,141,706
39,57,150,147,132,140,665
33,48,138,142,114,107,582
53,68,178,188,147,163,797
53,73,189,180,169,170,834
39,58,155,157,144,152,705
47,52,145,131,112,121,608
39,61,154,146,128,122,650
42,54,146,146,123,129,640
37,55,152,152,120,126,642
27,35,107,106,95,108,478
49,61,151,147,130,136,674
39,52,124,124,121,122,582
34,51,121,137,128,130,601
38,51,143,148,129,130,639
42,59,152,153,135,133,674
40,56,133,124,102,112,567
18,26,59,58,57,55,273
42,55,140,149,135,141,662
41,49,125,126,116,106,563
32,33,104,108,104,102,483
52,59,169,192,173,166,811
24,36,103,102,96,89,450
45,63,161,159,151,161,740
54,78,175,178,153,166,804
36,62,152,154,131,128,663
27,41,110,103,95,112,488
27,36,103,103,91,98,458
33,41,98,104,87,108,471
19,40,99,101,89,100,448
29,39,90,85,79,78,400
21,33,86,84,82,91,397
19,35,87,94,83,70,388
19,35,87,94,83,70,388
25,39,86,91,77,96,414
22,27,72,76,65,54,316
18,32,81,73,62,64,330
3,3,4,4,4,0,18
21,19,70,77,68,51,306
16,22,69,81,76,80,344
45,51,144,150,138,140,668
0,2,4,4,2,0,12
24,45,108,125,98,104,504
30,38,90,98,101,92,449
34,32,101,113,91,98,469
30,32,79,98,96,90,425
22,27,72,71,62,58,312
40,61,148,156,143,161,709
27,39,110,108,94,96,474
35,47,115,127,112,112,548
30,48,120,123,100,98,519
21,22,57,56,48,41,245
30,46,118,123,97,103,517
19,24,70,71,57,54,295
2,1,4,5,3,3,18
16,20,61,48,46,54,245
21,21,69,70,63,64,308
56,59,179,177,145,152,768
56,72,187,171,157,151,794
42,57,161,165,139,146,710
27,38,81,85,78,63,372
22,31,70,65,58,62,308
22,31,70,65,58,62,308
50,69,186,197,184,178,864
49,62,176,183,168,159,797
58,63,187,190,165,181,844
47,72,190,193,175,181,858
44,69,178,181,156,164,792
50,61,164,163,154,159,751
51,72,176,189,167,171,826
50,74,184,173,152,179,812
45,67,176,180,176,188,832
36,54,129,121,111,119,570
47,58,159,172,162,178,776
38,51,132,147,124,116,608
41,53,145,139,122,128,628
37,47,145,146,129,140,644
13,28,72,73,66,73,325
40,52,140,142,142,137,653
48,57,174,166,139,161,745
33,39,114,125,107,110,528
27,52,129,123,100,117,548
32,46,126,120,107,108,539
32,46,126,120,107,108,539
35,57,150,148,125,133,648
41,55,149,161,138,144,688
29,35,103,112,104,107,490
32,32,80,74,69,74,361
36,55,144,136,125,133,629
30,58,148,156,138,152,682
41,58,159,161,140,138,697
39,64,153,154,144,156,710
51,67,181,184,172,186,841
51,58,166,183,175,184,817
21,39,93,98,80,86,417
30,36,107,99,91,109,472
47,65,175,178,164,159,788
48,62,173,192,171,172,818
30,33,111,116,93,98,481
34,46,123,128,115,120,566
29,38,112,121,110,113,523
34,35,99,111,106,123,508
51,69,191,194,168,172,845
38,54,154,163,146,151,706
44,52,149,145,134,148,672
47,64,173,182,149,156,771
32,42,112,123,109,120,538
32,52,130,133,108,112,567
39,53,155,170,146,148,711
46,60,158,161,126,128,679
25,30,88,95,87,98,423
43,53,128,127,116,131,598
25,36,91,95,99,100,446
40,53,144,140,120,109,606
36,64,140,140,123,128,631
47,60,160,160,132,145,704
45,68,177,186,158,170,804
44,61,162,155,135,136,693
51,70,188,193,179,181,862
49,72,186,198,174,163,842
50,74,181,186,164,175,830
47,72,178,185,167,168,817
36,55,148,147,118,107,611
53,73,196,194,171,172,859
55,71,189,184,155,168,822
40,61,176,165,150,152,744
41,67,163,167,155,172,765
52,64,164,175,147,161,763
52,69,180,188,173,178,840
47,65,168,166,149,160,755
40,60,154,160,145,153,712
48,61,175,189,176,180,829
50,71,171,170,163,160,785
43,53,149,160,137,130,672
56,78,192,191,162,174,853
52,59,177,192,156,176,812
50,61,174,163,138,145,731
41,58,162,163,150,163,737
35,51,131,129,116,118,580
40,50,137,130,119,142,618
31,46,128,131,113,119,568
43,61,183,175,153,161,776
46,66,177,177,153,163,782
49,70,183,186,163,165,816
40,59,150,156,133,133,671
31,49,130,129,111,120,570
59,73,188,191,170,181,862
51,69,185,192,175,182,854
55,71,199,204,175,180,884
50,72,185,175,161,158,801
50,72,185,175,161,158,801
44,62,170,181,165,167,789
47,65,182,190,166,170,820
45,63,179,187,163,168,805
45,67,186,195,165,169,827
47,69,169,169,155,167,776
50,67,194,193,170,192,866
56,71,177,191,180,178,853
33,42,121,118,111,115,540
53,75,197,205,181,184,895
34,46,114,108,99,102,503
56,69,195,209,189,187,905
57,71,190,188,162,181,849
43,68,180,182,153,168,794
52,75,198,188,165,180,858
46,60,165,167,140,132,710
52,70,195,200,175,198,890
49,68,194,200,183,186,880
60,76,199,201,163,169,868
50,72,203,193,158,177,853
54,68,196,200,175,191,884
20,23,62,59,51,60,275
51,77,184,183,172,172,839
48,80,208,209,169,177,891
54,77,207,203,171,192,904
53,70,203,203,170,178,877
50,68,176,181,164,187,826
51,68,198,208,173,169,867
45,66,173,179,158,162,783
47,60,158,163,145,153,726
49,71,158,166,152,162,758
51,70,183,190,165,160,819
41,63,166,177,150,170,767
45,62,178,185,163,173,806
44,65,176,176,149,148,758
47,67,191,187,164,172,828
50,70,177,182,161,174,814
41,53,140,143,126,145,648
50,63,176,194,177,170,830
46,58,167,191,168,180,810
48,69,182,177,162,161,799
54,72,189,186,163,176,840
39,56,145,151,135,141,667
41,55,150,147,136,143,672
21,28,70,64,54,44,281
51,62,178,187,164,180,822
361,867,1730,1745,1376,1712,7791
32,53,129,132,116,121,583
39,56,142,146,126,133,642
49,73,190,182,157,160,811
37,52,158,164,143,145,699
38,52,151,147,140,149,677
42,61,156,165,149,142,715
47,60,161,177,156,165,766
46,57,161,159,140,147,710
50,67,173,171,143,131,735
39,61,165,160,129,152,706
36,54,153,158,140,148,689
44,62,162,158,139,161,726
51,75,183,168,149,156,782
16,26,76,83,63,50,314
27,46,122,120,100,100,515
39,47,124,113,95,113,531
38,45,120,117,99,114,533
31,45,112,120,102,99,509
25,48,124,132,120,133,582
32,44,132,145,123,120,596
28,33,110,115,97,85,468
51,67,182,181,168,190,839
49,69,186,194,159,188,845
52,68,191,194,173,189,867
47,68,166,164,139,132,716
43,68,183,175,145,147,761
41,65,181,175,153,162,777
30,41,106,110,105,122,514
22,49,125,133,106,74,509
50,77,194,193,178,172,864
48,72,190,196,168,170,844
51,70,181,182,161,162,807
20,32,86,82,60,65,345
51,71,198,182,163,184,849
49,69,184,187,167,182,838
47,72,189,188,157,149,802
55,69,185,186,150,164,809
50,69,190,212,190,192,903
48,68,185,207,184,173,865
51,64,183,203,167,160,828
42,68,178,178,167,181,814
43,68,187,183,151,156,788
405,1054,2183,2137,2007,2214,10000
222,558,1174,1174,1093,1167,5388
55,71,187,187,166,175,841
0,54,77,80,46,0,257
34,55,144,157,147,136,673
0,51,75,77,51,0,254
0,47,71,73,49,0,240
0,51,78,74,45,0,248
0,45,64,69,45,0,223
48,69,189,190,162,159,817
39,56,152,153,132,135,667
49,69,190,185,161,179,833
46,65,184,195,163,173,826
42,57,153,149,136,150,687
50,59,196,197,176,173,851
0,42,56,69,42,0,209
44,66,170,170,151,159,760
45,62,168,172,154,149,750
49,56,165,167,147,138,722
42,59,161,176,154,162,754
52,74,193,207,178,173,877
50,72,198,199,173,169,861
46,59,168,171,149,159,752
42,63,172,177,155,157,766
48,65,175,177,144,148,757
45,66,176,181,152,162,782
53,60,164,164,143,139,723
34,49,126,140,129,139,617
48,56,161,169,148,143,725
44,65,174,180,148,163,774
48,69,187,196,177,184,861
47,64,165,182,168,171,797
49,63,163,167,147,169,758
50,76,193,193,170,174,856
54,77,200,196,168,169,864
45,63,179,184,162,169,802
52,66,178,190,167,171,824
52,65,182,197,167,168,831
51,68,204,199,160,171,853
50,71,185,197,155,166,824
58,77,182,192,170,178,857
50,80,183,192,172,198,875
52,76,190,194,173,172,857
53,81,207,191,161,190,883
0,42,70,71,45,0,228
0,42,70,71,45,0,228
0,50,66,82,48,0,246
50,76,189,209,178,176,878
58,71,188,199,172,162,850
48,74,182,198,178,185,865
50,73,191,199,164,159,836
54,74,191,196,164,167,846
53,72,184,197,174,187,867
50,73,178,184,168,189,842
49,58,159,156,129,140,691
52,64,176,168,141,151,752
49,60,166,171,153,143,742
52,71,192,189,156,166,826
52,71,192,189,156,166,826
50,68,172,178,162,187,817
45,70,184,191,161,155,806
52,72,189,195,175,186,869
57,69,193,188,166,166,839
46,70,168,178,165,162,789
43,63,173,180,153,160,772
50,62,170,164,138,142,726
48,71,175,187,165,168,814
48,69,175,184,159,164,799
42,59,177,198,164,163,803
47,65,178,181,160,166,797
22,39,106,110,79,83,439
38,56,135,146,132,133,640
47,68,177,175,142,157,766
40,53,145,158,124,133,653
33,51,135,142,117,117,595
39,54,150,163,144,151,701
53,73,190,194,170,173,853
51,75,182,196,169,168,841
40,66,160,181,163,166,776
42,70,162,174,149,168,765
50,69,184,182,152,168,805
59,72,195,196,178,193,893
50,72,188,195,172,177,854
38,48,134,129,110,117,576
32,43,120,135,127,143,600
46,65,187,193,166,187,844
40,55,155,159,126,132,667
38,53,152,154,127,132,656
31,45,120,145,124,122,587
0,47,69,68,44,0,228
0,49,67,71,46,0,233
58,77,199,201,171,181,887
58,75,196,197,171,184,881
56,74,197,194,181,189,891
54,72,189,190,165,177,847
54,72,189,190,165,177,847
52,73,181,186,169,178,839
57,74,182,206,174,169,862
53,76,183,180,168,180,840
56,69,199,206,180,175,885
19,47,107,121,106,83,483
51,78,198,209,176,188,900
42,63,154,165,150,146,720
57,74,191,203,173,179,877
21,33,109,115,93,103,474
0,47,67,75,45,0,234
0,38,60,69,48,0,215
48,66,171,182,174,184,825
0,50,71,79,48,0,248
0,52,68,81,50,0,251
32,53,136,142,135,120,618
14,42,85,94,69,52,356
20,45,96,102,72,48,383
44,57,159,167,146,136,709
0,51,63,73,45,0,232
0,53,75,82,50,0,260
49,78,178,190,174,183,852
48,68,185,198,162,173,834
24,30,77,75,55,72,333
47,65,183,184,160,161,800
48,71,187,185,164,168,823
0,47,72,78,50,0,247
0,46,69,80,49,0,244
0,51,69,76,46,0,242
0,59,78,68,43,0,248
0,53,71,77,47,0,248
0,51,66,78,42,0,237
54,68,196,205,189,185,897
0,42,67,77,52,0,238
66,84,207,207,179,190,933
59,77,203,208,180,184,911
54,77,174,173,149,154,781
43,50,149,160,145,138,685
0,46,62,68,45,0,221
52,70,183,200,185,181,871
35,52,121,129,116,120,573
48,73,200,192,149,151,813
57,73,180,188,173,187,858
29,39,45,61,50,39,263
60,77,182,195,170,174,858
52,78,195,187,166,170,848
49,64,165,175,148,152,753
46,59,167,173,147,160,752
39,59,112,118,103,115,546
33,45,86,98,86,90,438
50,66,172,171,144,143,746
49,70,185,200,159,166,829
41,54,121,120,97,105,538
28,41,45,50,42,43,249
40,55,100,101,72,82,450
31,39,73,75,62,77,357
32,36,46,49,44,44,251
0,46,66,84,54,0,250
37,43,43,46,49,42,260
43,63,167,161,134,141,709
27,37,85,73,66,83,371
46,61,151,154,126,132,670
46,60,175,183,154,168,786
0,44,75,87,52,0,258
49,72,166,177,151,150,765
36,64,133,128,104,87,552
4,52,76,84,46,8,270
55,68,189,186,167,179,844
59,72,179,189,173,185,857
0,47,68,73,41,0,229
31,39,43,52,50,48,263
30,43,107,111,95,91,477
40,53,140,161,143,138,675
34,57,98,96,76,77,438
0,48,68,72,47,2,237
64,81,193,200,188,201,927
59,79,192,203,176,174,883
58,75,188,199,177,173,870
36,47,50,54,44,41,272
17,19,59,65,56,54,270
24,32,29,40,42,31,198
24,30,36,36,39,43,208
59,78,182,186,168,179,852
51,73,178,182,158,170,812
9,25,70,72,58,55,289
35,39,38,44,44,43,243
50,68,189,199,169,181,856
36,38,109,117,110,120,530
55,74,187,195,165,185,861
56,78,208,206,163,177,888
34,49,51,50,47,47,278
2,6,6,4,4,8,30
30,37,117,117,99,111,511
27,41,99,108,94,98,467
58,71,192,194,176,187,878
58,81,207,210,177,189,922
62,75,197,197,173,188,892
52,71,179,196,170,166,834
53,68,182,190,166,180,839
35,41,41,39,34,32,222
64,81,196,211,175,173,900
56,78,180,199,173,181,867
58,79,196,208,178,181,900
58,75,192,204,172,184,885
50,71,183,189,165,181,839
52,63,189,203,177,180,864
51,77,196,204,175,181,884
32,38,40,46,33,39,228
49,71,185,188,178,182,853
39,59,166,169,147,146,726
46,68,176,168,143,153,754
47,67,187,192,171,181,845
46,65,161,172,155,165,764
23,30,37,42,33,28,193
54,74,190,188,160,167,833
24,32,34,38,38,36,202
54,74,187,183,164,179,841
47,72,176,193,166,166,820
56,85,206,205,193,183,928
51,78,190,202,179,180,880
15,28,30,26,30,30,159
53,75,199,203,174,189,893
22,28,33,32,29,34,178
27,32,42,45,48,36,230
26,34,41,43,39,32,215
28,34,43,46,39,39,229
30,35,44,50,38,39,236
33,45,131,125,105,121,560
49,71,180,196,181,194,871
36,53,138,146,124,122,619
45,67,157,162,149,159,739
49,71,182,190,171,189,852
55,73,194,201,172,178,873
55,76,192,186,169,188,866
48,66,172,186,171,175,818
49,72,185,189,174,186,855
26,39,117,115,90,90,477
23,38,40,36,30,22,189
50,74,187,196,164,163,834
54,72,180,189,181,159,835
51,70,189,204,176,172,862
47,74,180,193,175,177,846
45,66,167,178,166,172,794
52,69,185,193,164,177,840
20,30,33,37,35,32,187
22,37,36,38,37,31,201
50,79,195,204,174,182,884
24,36,35,37,30,30,192
44,62,150,158,131,136,681
24,35,38,44,38,27,206
23,26,36,44,34,37,200
52,79,192,196,168,183,870
25,38,112,107,81,90,453
49,72,180,199,164,170,834
50,71,172,167,148,168,776
44,71,186,178,156,156,791
49,75,189,192,162,172,839
47,60,182,184,156,153,782
48,63,183,182,164,172,812
30,52,117,120,104,103,526
35,57,122,121,112,122,569
43,65,159,168,148,156,739
44,67,164,169,144,161,749
28,33,36,29,28,35,189
13,27,81,90,84,77,372
24,33,83,83,67,86,376
15,22,20,27,27,19,130
52,82,97,93,72,60,456
52,73,185,196,174,149,829
49,68,173,165,142,140,737
41,59,148,146,132,143,669
24,33,26,28,25,21,157
26,36,34,35,34,36,201
29,38,51,52,44,36,250
45,78,89,88,63,54,417
19,29,85,83,73,86,375
10,10,24,21,15,17,97
24,46,100,118,107,102,497
46,61,162,163,132,142,706
2,5,2,3,4,11,27
50,63,163,172,150,146,744
4,3,2,3,7,11,30
35,47,136,135,114,127,594
0,4,6,3,1,0,14
0,31,53,58,37,0,179
0,41,62,67,44,0,214
38,51,133,150,123,117,612
42,58,165,179,154,160,758
30,44,104,115,105,112,510
23,32,102,107,94,97,455
45,65,184,175,150,171,790
37,31,75,81,66,70,360
32,49,104,95,80,95,455
41,57,149,152,130,132,661
57,74,195,202,186,195,909
25,33,34,44,36,36,208
18,30,78,84,70,59,339
18,32,90,95,81,89,405
40,58,168,182,151,152,751
45,55,165,161,140,158,724
40,55,130,118,108,116,567
37,51,143,146,136,136,649
45,63,183,185,159,154,789
51,77,184,189,160,171,832
44,54,155,157,140,138,688
45,57,152,164,144,153,715
32,46,123,126,106,99,532
30,48,127,133,109,110,557
49,61,174,174,157,170,785
44,64,180,193,179,172,832
46,70,184,190,166,163,819
42,54,148,157,143,149,693
38,56,150,162,145,154,705
53,70,183,183,156,168,813
48,67,188,181,143,163,790
55,71,192,194,166,164,842
42,72,179,190,171,181,835
49,64,164,163,140,136,716
34,57,134,136,123,141,625
45,54,156,162,140,137,694
45,53,152,168,144,144,706
29,47,112,105,89,108,490
50,59,161,155,138,153,716
0,47,63,78,49,0,237
0,48,76,75,47,0,246
0,50,69,85,54,0,258
53,68,170,180,162,150,783
0,49,73,80,57,0,259
0,41,63,79,49,0,232
48,71,180,187,166,182,834
44,61,167,181,162,184,799
13,33,71,70,65,48,300
11,42,73,94,83,51,354
49,64,175,180,155,161,784
31,41,107,111,106,122,518
67,87,208,210,181,188,941
35,51,126,133,114,121,580
35,46,49,59,49,41,279
0,44,69,75,44,0,232
33,42,45,53,44,47,264
38,46,47,44,42,40,257
0,47,79,83,54,0,263
36,48,45,45,42,39,255
34,39,38,44,41,44,240
46,58,147,157,136,149,693
27,31,30,32,32,32,184
16,21,45,43,39,44,208
47,69,177,192,165,146,796
38,58,138,149,136,137,656
21,38,52,54,47,45,257
24,37,97,96,76,89,419
8,7,21,13,10,22,81
35,54,136,145,131,124,625
19,19,62,67,58,57,282
49,59,174,170,147,148,747
46,59,169,171,150,148,743
24,43,113,105,86,77,448
46,62,167,158,141,157,731
29,33,95,101,84,78,420
51,69,185,189,169,169,832
23,28,82,87,75,77,372
41,60,167,167,139,138,712
40,58,161,171,149,147,726
45,60,157,165,147,150,724
38,56,149,161,145,153,702
32,37,98,100,99,113,479
47,55,160,152,138,164,716
27,34,109,114,99,94,477
27,35,111,116,97,104,490
34,43,116,109,102,115,519
41,63,161,163,152,156,736
53,67,188,199,175,174,856
41,69,173,176,158,185,802
40,52,152,159,140,149,692
42,71,200,201,163,163,840
47,66,189,206,171,173,852
50,67,194,181,162,195,849
48,71,180,195,164,163,821
41,62,172,180,158,175,788
45,61,175,181,159,165,786
41,50,148,158,127,138,662
41,62,159,165,149,146,722
51,69,193,206,166,170,855
54,72,176,191,163,183,839
0,51,75,79,47,0,252
4,45,75,84,49,1,258
44,68,156,159,139,144,710
37,51,138,145,121,134,626
37,51,138,145,121,135,627
21,19,63,71,68,60,302
55,67,175,188,154,170,809
25,30,92,95,76,78,396
42,59,150,144,120,115,630
0,52,72,72,39,0,235
51,70,180,184,160,172,817
46,57,161,176,146,157,743
54,69,192,192,167,183,857
52,78,196,204,168,180,878
52,68,183,186,164,166,819
55,74,191,191,170,195,876
49,61,174,175,153,158,770
18,25,71,90,71,73,348
12,25,53,54,58,78,280
18,30,80,82,61,72,343
49,61,188,187,155,151,791
42,49,106,121,110,109,537
18,25,71,79,74,55,322
17,26,65,70,70,82,330
21,27,82,80,63,72,345
50,66,189,188,154,174,821
52,61,167,177,168,163,788
47,62,180,172,169,165,795
33,28,89,88,78,88,404
49,56,164,154,134,152,709
48,72,166,179,166,169,800
53,68,192,211,188,173,885
42,54,149,158,143,149,695
26,48,130,135,122,118,579
34,40,114,108,93,104,493
42,59,162,166,150,151,730
44,55,165,176,156,153,749
55,72,190,194,171,166,848
40,43,40,42,38,40,243
32,40,43,39,43,46,243
38,56,140,140,119,120,613
52,65,175,164,136,145,737
45,63,165,176,152,173,774
41,59,162,164,135,132,693
35,44,134,139,125,122,599
38,57,156,152,127,140,670
41,58,159,174,144,154,730
38,59,156,158,139,136,686
33,41,44,48,46,51,263
37,49,143,145,116,116,606
40,54,139,140,122,112,607
12,21,62,65,55,61,276
42,54,140,152,147,145,680
1,1,4,7,6,9,28
48,66,169,188,168,181,820
25,32,38,42,33,32,202
39,55,135,136,128,127,620
41,52,146,141,116,128,624
27,49,126,122,106,124,554
43,67,151,160,140,123,684
43,67,151,160,140,123,684
27,29,89,86,64,66,361
43,69,137,146,130,144,669
40,50,136,143,119,116,604
44,60,166,169,140,128,707
32,44,118,123,111,128,556
29,47,125,138,116,112,567
23,29,85,87,68,81,373
50,69,171,177,156,167,790
45,60,175,174,145,152,751
19,24,55,50,37,49,234
19,31,68,65,50,49,282
17,24,78,83,69,69,340
27,31,84,84,81,96,403
55,78,206,202,169,172,882
50,70,179,177,159,153,788
50,63,171,179,157,153,773
41,53,133,127,119,132,605
18,32,26,34,23,22,155
46,64,158,165,141,152,726
43,67,160,154,153,170,747
35,45,107,106,100,107,500
35,47,123,128,120,123,576
50,69,172,189,167,168,815
20,35,78,80,67,71,351
27,32,80,83,77,80,379
22,25,77,87,83,89,383
2,4,8,7,5,7,33
42,58,161,163,141,149,714
28,36,111,109,103,100,487
30,39,113,123,101,114,520
29,43,108,118,107,116,521
4,4,2,3,3,2,18
3,5,8,7,4,14,41
40,53,139,145,124,125,626
4,3,4,3,2,0,16
48,65,181,176,166,169,805
47,63,174,172,144,167,767
24,30,32,31,31,32,180
3,7,7,5,5,7,34
5,3,8,6,6,7,35
1,4,3,4,4,5,21
26,38,97,93,74,75,403
46,63,157,159,139,144,708
18,28,82,94,86,78,386
19,18,57,55,52,67,268
30,36,99,102,95,93,455
51,73,187,180,151,151,793
42,63,143,143,128,137,656
51,71,175,197,181,187,862
21,32,84,84,72,68,361
11,25,72,80,73,66,327
21,31,78,78,65,72,345
16,21,45,43,39,44,208
24,33,98,104,92,79,430
18,26,65,62,57,54,282
30,47,117,114,82,75,465
7,7,6,3,2,6,31
20,29,80,73,59,72,333
5,4,5,4,4,11,33
20,38,94,98,84,85,419
23,37,98,90,86,92,426
26,28,91,95,97,93,430
23,30,74,70,66,67,330
28,37,101,116,104,110,496
39,51,146,152,135,161,684
2,3,6,6,3,3,23
30,32,44,49,50,44,249
5,9,9,13,16,19,71
37,55,135,158,141,131,657
43,63,172,177,153,169,777
42,66,157,153,128,126,672
46,69,175,170,162,165,787
26,32,73,81,79,69,360
46,72,190,185,171,187,851
58,74,188,184,162,178,844
49,69,183,193,176,168,838
53,81,198,197,161,162,852
49,77,93,102,76,66,463
14,23,64,66,60,63,290
61,97,209,204,180,194,945
41,64,147,162,143,145,702
