49,70,184,191,154,179,827
18,21,58,72,71,81,321
8,11,24,22,31,28,124
29,30,82,81,74,82,378
51,69,188,189,158,168,823
14,20,42,39,34,30,179
38,62,148,149,131,144,672
22,27,74,71,63,56,313
26,27,59,67,68,46,293
52,80,185,189,174,168,848
21,30,91,104,74,93,413
16,18,61,70,49,65,279
25,26,76,77,70,74,348
17,24,78,82,80,92,373
6,8,20,25,17,11,87
24,19,49,56,55,61,264
11,19,35,44,41,42,192
21,33,81,81,61,68,345
11,17,55,66,59,54,262
17,26,65,53,37,40,238
14,21,43,51,55,55,239
25,25,66,54,55,60,285
35,50,135,144,123,119,606
21,28,73,68,69,73,332
53,74,190,199,175,180,871
27,30,87,92,83,77,396
26,35,96,102,103,101,463
26,28,99,101,85,83,422
59,70,180,189,152,168,818
11,17,39,48,38,38,191
24,25,70,60,49,44,272
48,59,169,171,151,156,754
30,34,88,97,91,100,440
29,37,94,105,103,98,466
45,71,175,190,173,175,829
35,59,148,157,128,140,667
11,17,46,61,42,31,208
13,23,57,67,63,54,277
11,23,60,56,38,30,218
11,24,52,58,41,36,222
44,57,144,148,133,146,672
41,60,157,151,138,140,687
50,61,183,186,161,167,808
49,69,175,175,147,156,771
16,26,62,61,34,31,230
25,33,92,102,91,86,429
21,29,73,91,78,77,369
24,44,99,100,82,99,448
46,62,174,180,144,147,753
6,10,17,16,13,16,78
21,26,77,80,77,78,359
5,9,18,22,21,26,101
48,57,153,166,138,136,698
25,24,74,88,81,66,358
20,25,57,65,69,79,315
20,32,76,79,62,64,333
20,29,82,91,77,81,380
4,8,8,8,5,9,42
11,17,51,54,28,28,189
14,17,35,32,31,37,166
24,25,84,84,72,71,360
25,33,82,83,65,66,354
18,29,85,78,61,72,343
38,50,131,135,120,131,605
10,20,68,61,38,36,233
22,30,75,70,67,75,339
17,34,77,69,52,59,308
21,16,57,62,50,43,249
49,66,187,196,177,166,841
25,31,90,96,87,96,425
33,43,100,109,94,88,467
42,57,171,165,159,159,753
50,66,176,186,175,175,828
56,74,192,202,163,162,849
18,35,83,95,86,70,387
6,9,37,45,42,39,178
25,38,91,111,105,114,484
28,34,81,80,84,76,383
36,50,130,131,102,107,556
32,40,95,89,83,82,421
8,25,57,66,44,33,233
40,54,153,157,135,142,681
38,50,142,161,128,131,650
22,46,95,87,72,70,392
47,69,165,169,142,155,747
11,22,48,47,34,23,185
10,21,60,48,37,31,207
9,22,56,55,42,34,218
39,62,160,170,140,140,711
14,15,43,54,58,69,253
22,35,103,108,92,108,468
21,25,79,83,78,81,367
39,50,138,140,120,135,622
34,50,117,110,102,86,499
41,59,158,155,126,139,678
46,62,169,201,171,181,830
25,31,90,92,87,77,402
10,21,56,42,24,27,180
3,10,23,20,16,18,90
34,34,97,106,91,100,462
43,66,174,173,156,165,777
31,42,108,104,89,105,479
50,72,186,192,171,166,837
23,42,100,89,72,87,413
28,41,106,105,88,77,445
40,59,160,166,145,153,723
11,13,45,47,31,38,185
7,24,62,57,36,30,216
10,10,32,40,27,24,143
34,34,94,99,92,84,437
12,16,46,49,26,21,170
47,61,163,158,151,160,740
18,31,75,92,80,66,362
15,21,58,70,52,33,249
25,37,91,110,104,113,480
10,21,59,60,40,43,233
25,29,83,88,78,75,378
20,37,90,98,94,103,442
25,39,92,90,77,71,394
45,68,169,180,162,159,783
14,20,54,55,48,62,253
17,22,71,77,55,39,281
4,10,31,37,17,16,115
20,24,66,58,56,56,280
37,55,147,152,123,119,633
54,71,187,192,162,164,830
34,56,148,153,134,138,663
39,48,112,114,97,78,488
50,68,181,190,173,180,842
15,24,62,55,42,45,243
4,15,35,37,30,24,145
13,24,56,62,43,37,235
12,22,61,57,36,34,222
30,50,136,143,130,128,617
25,35,90,94,86,77,407
43,57,144,157,127,117,645
43,65,172,179,171,171,801
23,35,84,78,70,74,364
18,34,78,77,48,46,301
19,18,53,52,43,48,233
45,63,173,155,141,163,740
24,33,88,76,66,60,347
13,22,41,41,33,24,174
10,14,34,36,35,34,163
15,16,52,55,54,67,259
9,20,40,44,26,38,177
27,30,89,80,70,95,391
22,36,99,110,96,109,472
19,30,83,83,77,80,372
44,61,169,184,162,161,781
42,45,111,92,85,102,477
41,59,141,142,122,135,640
16,20,50,53,29,25,193
35,39,102,90,77,95,438
22,25,74,77,57,49,304
31,43,113,119,102,89,497
48,64,167,188,158,168,793
36,54,143,140,129,143,645
6,17,53,58,42,23,199
14,25,73,71,56,65,304
14,24,52,47,48,60,245
49,62,176,185,168,161,801
18,20,61,62,33,40,234
17,27,66,56,44,37,247
26,34,91,89,80,69,389
11,11,36,37,31,29,155
6,3,7,9,8,9,42
28,36,100,97,81,90,432
28,27,91,100,98,89,433
53,73,179,180,160,172,817
18,23,58,56,40,45,240
7,19,48,39,29,28,170
51,72,177,190,171,172,833
4,5,10,9,7,8,43
20,23,62,49,52,73,279
37,56,137,155,141,156,682
18,24,72,69,52,71,306
14,35,74,71,72,73,339
49,66,170,163,140,134,722
18,21,55,57,47,50,248
33,52,134,121,105,105,550
21,27,83,79,76,78,364
4,6,19,15,10,14,68
14,25,65,67,39,32,242
16,19,54,64,57,74,284
22,33,88,108,86,84,421
49,63,181,192,160,173,818
58,65,184,189,159,163,818
39,61,168,163,138,148,717
1,1,1,4,4,6,17
12,22,57,73,65,57,286
40,38,117,106,90,96,487
17,21,44,47,38,30,197
54,75,182,189,164,167,831
29,38,109,95,73,79,423
22,32,81,96,82,76,389
16,30,66,64,34,21,231
10,21,60,48,37,31,207
16,24,70,61,48,31,250
18,24,66,73,48,48,277
8,7,28,38,31,25,137
16,12,45,49,36,34,192
26,29,95,98,92,95,435
24,32,90,74,64,80,364
5,8,15,27,27,27,109
6,10,18,25,20,16,95
12,22,66,71,45,44,260
27,38,92,85,72,76,390
19,22,58,47,38,52,236
38,61,152,175,144,142,712
40,51,130,145,130,155,651
17,27,72,70,57,62,305
7,19,54,51,23,28,182
32,34,98,88,82,90,424
11,24,69,75,52,40,271
12,30,76,63,41,44,266
25,28,72,67,70,70,332
52,66,185,195,168,169,835
20,24,56,51,46,45,242
45,69,186,185,166,177,828
38,61,175,188,147,155,764
22,36,95,97,73,85,408
28,34,89,91,84,90,416
10,16,41,44,29,27,167
35,32,103,112,94,100,476
16,33,98,114,98,103,462
29,36,93,109,89,87,443
40,51,140,132,100,117,580
9,13,34,36,34,34,160
29,33,81,84,63,57,347
19,24,62,63,62,70,300
15,21,56,61,53,60,266
26,37,99,91,82,86,421
28,35,85,97,93,95,433
6,11,21,29,27,22,116
30,51,135,131,110,117,574
52,65,182,184,168,165,816
53,75,183,185,160,177,833
39,59,154,167,139,150,708
10,23,61,62,38,33,227
9,10,32,39,32,24,146
7,12,30,20,18,27,114
21,39,77,71,73,81,362
4,14,32,42,29,21,142
20,30,74,88,73,76,361
10,24,55,50,27,27,193
23,28,60,52,44,49,256
28,27,93,95,81,75,399
25,33,91,93,79,72,393
6,11,24,29,26,18,114
35,42,138,152,123,124,614
41,59,163,170,131,123,687
11,21,61,74,48,27,242
49,66,186,185,159,167,812
8,13,41,37,28,30,157
21,33,95,96,77,77,399
22,35,90,100,89,115,451
3,3,2,6,7,11,32
12,30,67,53,34,37,233
35,39,102,106,102,104,488
5,11,21,24,25,21,107
31,45,106,110,108,115,515
55,66,178,187,168,174,828
8,17,41,58,50,37,211
35,46,120,123,107,111,542
34,50,118,110,103,88,503
26,39,89,92,90,84,420
30,50,122,121,104,109,536
38,57,139,145,129,137,645
17,28,64,66,43,37,255
16,30,90,100,86,113,435
55,61,174,187,170,169,816
51,66,176,181,146,147,767
36,58,150,148,130,119,641
33,39,102,107,102,103,486
4,3,13,10,13,10,53
16,25,70,69,55,45,280
15,31,75,65,41,40,267
21,38,100,121,103,107,490
25,47,100,100,87,101,460
27,31,95,89,76,86,404
14,20,52,59,42,39,226
55,78,192,207,164,172,868
31,36,94,102,84,80,427
8,15,48,55,36,34,196
13,14,41,50,36,28,182
46,60,173,186,163,133,761
13,18,32,31,30,38,162
38,56,136,131,107,116,584
44,63,177,162,132,144,722
20,24,71,78,59,67,319
17,21,49,54,48,51,240
33,46,139,143,119,113,593
24,41,101,98,92,95,451
16,22,56,60,45,54,253
39,52,133,142,117,110,593
11,19,51,57,40,42,220
31,39,102,105,84,91,452
12,7,32,33,25,25,134
33,45,123,118,96,87,502
8,8,18,33,28,26,121
14,27,50,50,54,45,240
46,58,150,145,134,118,651
44,56,153,156,138,141,688
30,53,137,131,108,119,578
11,16,37,42,28,30,164
12,21,49,57,35,26,200
33,48,106,100,98,110,495
2,4,5,7,4,9,31
16,22,63,51,44,50,246
20,28,86,97,71,69,371
42,51,148,137,106,123,607
17,28,77,83,71,75,351
49,68,188,188,141,143,777
40,44,115,103,92,96,490
15,27,69,68,51,50,280
37,53,135,148,124,141,638
40,60,172,174,165,142,753
13,22,56,50,36,33,210
26,34,87,90,88,81,406
50,65,186,187,162,159,809
35,47,130,134,110,116,572
29,36,91,100,92,89,437
40,70,173,170,152,156,761
53,68,183,194,174,189,861
52,66,185,181,164,170,818
19,30,79,83,83,81,375
10,14,32,37,40,30,163
37,57,142,142,125,145,648
34,48,123,115,97,111,528
48,63,163,175,138,146,733
3,4,6,10,7,7,37
35,40,107,100,88,86,456
21,36,82,80,72,81,372
35,53,144,161,130,136,659
19,30,66,61,41,39,256
10,16,41,38,38,28,171
12,16,50,49,34,34,195
9,22,60,66,49,42,248
41,55,149,173,150,148,716
28,36,98,100,88,83,433
42,54,147,149,122,130,644
20,32,92,107,79,83,413
20,27,89,87,66,76,365
23,31,86,81,70,72,363
21,23,62,57,56,53,272
40,71,174,170,151,156,762
48,65,184,201,176,165,839
6,5,7,3,2,6,29
42,59,162,178,160,168,769
16,30,63,64,45,39,257
48,57,161,169,149,143,727
30,51,123,127,99,91,521
28,32,79,73,63,72,347
10,18,42,45,35,30,180
7,6,4,6,3,5,31
10,26,65,65,58,68,292
5,10,22,26,25,17,105
17,23,66,74,66,74,320
20,24,77,76,71,71,339
10,17,45,46,32,23,173
21,25,71,65,48,56,286
22,23,75,73,73,83,349
27,32,100,94,96,106,455
28,34,90,98,104,100,454
22,19,71,72,59,68,311
18,33,84,93,80,85,393
22,36,87,92,67,59,363
29,42,105,101,83,99,459
4,3,5,3,1,2,18
9,5,14,11,6,7,52
5,4,6,9,9,10,43
20,25,88,94,79,87,393
27,25,70,84,67,72,345
48,64,180,184,166,159,801
18,26,71,88,79,77,359
10,14,38,34,26,28,150
14,12,36,50,35,33,180
38,56,159,162,133,132,680
46,61,174,165,161,148,755
13,18,55,56,44,40,226
36,51,131,143,112,111,584
48,53,157,157,130,130,675
47,62,182,175,149,150,765
11,18,45,51,39,39,203
38,53,155,153,139,142,680
39,55,159,163,130,139,685
9,6,5,7,7,5,39
38,58,152,142,119,129,638
7,6,24,23,20,15,95
40,41,143,147,124,130,625
42,47,140,133,127,127,616
25,28,77,82,75,56,343
26,28,98,101,84,83,420
26,39,100,109,98,111,483
10,15,50,46,30,26,177
42,56,163,168,135,142,706
14,13,34,29,31,36,157
37,52,135,156,143,157,680
7,13,40,43,26,22,151
46,61,172,163,141,146,729
35,57,150,150,129,130,651
17,15,45,46,43,44,210
34,36,98,95,75,86,424
42,53,143,127,113,139,617
17,32,76,82,58,78,343
41,53,162,152,123,129,660
10,23,50,46,30,25,184
37,49,156,160,127,129,658
42,59,162,163,147,149,722
20,24,72,64,61,82,323
42,52,148,151,124,132,649
45,53,143,136,125,139,641
29,45,126,131,99,94,524
6,6,4,3,3,5,27
8,15,41,42,31,40,177
13,17,48,58,40,35,211
15,22,61,47,39,45,229
2,2,2,5,11,5,27
23,27,69,69,48,52,288
35,47,124,122,112,126,566
12,20,64,71,43,31,241
5,3,15,9,11,9,52
11,12,25,23,23,25,119
1,0,2,5,4,1,13
12,21,58,56,40,29,216
46,68,179,189,164,161,807
21,28,79,76,63,68,335
29,35,104,115,90,85,458
13,19,46,52,37,34,201
46,64,180,183,149,143,765
6,15,45,50,37,31,184
12,20,60,49,33,34,208
16,22,65,59,52,51,265
42,61,163,169,151,160,746
3,3,2,7,8,6,29
40,52,138,146,132,145,653
5,8,18,12,13,8,64
51,67,186,175,161,156,796
25,37,89,106,95,75,427
2,7,11,12,9,9,50
47,51,144,148,128,114,632
8,20,46,46,30,25,175
21,29,81,83,71,72,357
50,66,172,181,162,153,784
7,11,32,36,21,20,127
21,30,76,70,61,68,326
24,43,96,96,93,103,455
46,64,181,192,164,173,820
2,3,4,6,6,3,24
5,16,45,51,29,29,175
9,19,46,51,39,43,207
24,29,94,112,100,93,452
11,12,39,41,25,27,155
17,12,31,32,24,39,155
38,53,167,145,121,123,647
50,54,169,157,149,148,727
4,3,5,3,4,4,23
11,18,63,59,39,33,223
35,39,140,153,127,135,629
37,56,155,167,140,139,694
47,63,188,185,169,168,820
9,20,56,55,40,31,211
5,6,14,14,11,19,69
8,13,28,39,32,28,148
48,64,176,175,153,158,774
9,25,48,47,33,27,189
3,6,9,12,8,3,41
7,7,11,9,9,13,56
33,46,144,131,108,111,573
48,66,174,194,161,163,806
34,54,131,136,118,116,589
53,65,186,195,179,171,849
36,52,145,146,109,98,586
37,53,150,158,139,143,680
46,51,156,157,129,129,668
44,52,156,142,126,133,653
28,44,108,109,107,108,504
24,41,82,74,78,68,367
9,22,65,60,36,31,223
47,58,159,164,151,165,744
14,23,52,44,44,52,229
43,47,145,136,128,130,629
46,64,180,182,148,143,763
6,8,19,12,9,20,74
14,24,58,67,62,60,285
8,9,27,24,16,13,97
38,60,147,149,148,155,697
12,27,74,70,49,44,276
3,3,1,3,2,2,14
42,51,151,162,136,138,680
10,12,49,52,32,23,178
54,69,188,184,161,159,815
2,1,4,5,3,4,19
31,37,100,111,106,97,482
30,39,100,110,96,110,485
44,61,177,162,144,141,729
12,19,40,42,29,28,170
21,31,89,93,78,74,386
35,53,136,139,135,146,644
50,71,190,179,153,137,780
30,30,95,96,71,82,404
43,53,152,161,140,135,684
6,5,12,17,13,9,62
37,56,153,160,135,132,673
45,54,144,145,130,138,656
49,67,174,172,151,155,768
1,1,3,5,4,0,14
45,62,163,170,163,145,748
42,67,187,187,167,165,815
41,53,165,157,130,141,687
48,57,167,171,159,150,752
2,3,2,7,7,1,22
4,3,4,6,7,3,27
9,17,35,45,36,30,172
11,15,40,54,41,34,195
31,41,119,130,116,113,550
52,64,172,162,150,164,764
1,3,3,1,2,7,17
41,52,159,144,145,167,708
13,21,54,46,23,19,176
44,63,172,167,153,159,758
36,41,108,99,93,96,473
42,60,154,150,139,150,695
3,5,6,10,8,10,42
52,61,171,171,151,147,753
3,4,16,18,10,15,66
16,22,60,64,45,50,257
39,59,161,166,134,137,696
23,36,88,90,76,91,404
41,54,145,152,129,136,657
30,39,91,89,85,81,415
51,68,189,193,167,161,829
3,8,14,29,27,23,104
37,49,125,132,102,101,546
25,37,82,73,74,88,379
17,25,67,86,75,74,344
36,46,145,134,110,126,597
8,20,40,47,36,21,172
37,52,144,150,135,142,660
47,66,179,184,183,177,836
9,27,46,46,31,25,184
46,66,167,174,147,142,742
23,43,93,108,106,125,498
34,42,131,131,117,134,589
4,11,19,21,17,26,98
44,60,170,155,145,154,728
11,19,50,53,35,26,194
34,30,98,97,72,85,416
10,20,59,65,36,40,230
3,9,14,19,11,10,66
39,62,182,180,141,138,742
46,61,155,147,134,122,665
3,5,4,2,2,2,18
23,33,87,93,71,69,376
23,29,81,85,81,67,366
25,33,78,88,76,68,368
16,16,64,70,48,41,255
18,17,51,55,38,47,226
13,15,44,50,39,40,201
14,23,83,77,50,56,303
22,27,62,84,87,81,363
20,35,105,115,74,64,413
2,1,5,6,5,2,21
3,4,4,7,7,6,31
38,39,118,124,89,94,502
15,27,84,80,62,59,327
18,36,91,88,52,54,339
30,48,105,117,76,86,462
28,38,97,104,99,102,468
24,36,83,73,66,65,347
11,20,76,74,42,40,263
10,17,52,57,43,38,217
5,6,2,11,9,1,34
13,21,55,57,45,46,237
0,1,2,4,3,3,13
15,11,31,44,30,36,167
12,20,69,83,49,39,272
18,35,108,93,57,59,370
23,36,85,67,54,58,323
14,25,74,86,55,40,294
10,20,64,55,31,28,208
10,12,40,45,44,42,193
4,5,4,3,2,4,22
18,20,47,50,34,44,213
26,30,75,83,77,71,362
26,33,96,97,93,88,433
2,7,19,21,13,16,78
5,5,7,12,11,6,46
27,42,101,100,82,97,449
25,33,91,89,70,85,393
22,39,78,97,91,88,415
10,10,42,51,39,38,190
12,20,64,69,40,39,244
14,25,63,67,59,49,277
10,12,48,54,30,28,182
20,32,98,98,61,50,359
4,6,4,6,5,8,33
20,26,76,75,74,64,335
2,1,2,3,2,0,10
18,33,91,95,58,45,340
3,7,11,16,10,10,57
15,26,79,77,56,51,304
28,41,103,89,74,81,416
11,15,53,60,38,37,214
11,19,61,60,35,31,217
16,26,75,74,55,50,296
19,31,86,86,64,57,343
17,26,59,59,59,61,281
1,0,4,3,1,0,9
34,45,110,126,107,106,528
18,30,84,78,65,62,337
14,18,50,59,41,47,229
27,31,90,90,85,78,401
20,33,62,58,64,57,294
26,37,99,108,99,95,464
31,37,105,118,101,109,501
19,30,96,97,70,52,364
12,15,55,53,28,34,197
21,37,98,106,84,75,421
13,18,67,67,44,29,238
23,35,80,98,84,79,399
17,32,104,92,59,44,348
33,39,101,97,92,91,453
14,19,57,52,47,44,233
18,32,79,69,49,52,299
12,15,33,32,29,33,154
16,22,57,65,40,44,244
7,10,27,26,30,31,131
6,5,6,8,10,20,55
21,29,72,65,48,64,299
17,33,108,119,79,55,411
11,21,73,63,43,41,252
8,9,35,43,32,37,164
5,3,4,2,1,2,17
18,37,112,103,62,63,395
1,3,2,2,3,6,17
1,2,1,5,4,7,20
12,18,56,53,32,36,207
11,17,50,57,48,49,232
20,32,97,86,60,59,354
7,6,9,9,7,6,44
11,26,79,68,41,40,265
15,24,74,74,60,44,291
29,43,103,100,85,92,452
13,24,75,65,40,40,257
25,30,84,82,73,82,376
14,18,42,47,35,37,193
16,32,106,98,70,58,380
28,42,123,122,107,115,537
2,4,3,1,1,0,11
3,0,3,8,7,6,27
9,23,68,70,49,26,245
26,33,85,97,93,95,429
22,17,68,88,83,80,358
28,41,113,119,109,105,515
3,3,7,6,3,7,29
11,14,44,52,45,29,195
21,30,88,81,61,82,363
16,25,64,68,49,47,269
15,19,41,47,32,36,190
8,12,43,48,37,30,178
16,37,91,80,55,54,333
5,3,4,5,4,3,24
1,1,0,0,1,2,5
11,27,76,88,68,55,325
27,32,99,99,70,66,393
3,4,3,3,5,4,22
25,49,120,124,94,101,513
23,35,107,101,72,61,399
27,37,97,101,82,91,435
3,0,5,3,4,4,19
5,4,4,6,5,1,25
2,2,5,4,4,4,21
9,18,49,52,34,31,193
10,14,35,44,32,33,168
11,22,48,51,43,30,205
3,4,1,0,0,0,8
12,25,83,87,54,41,302
9,12,36,42,33,30,162
11,10,27,33,39,36,156
14,17,47,53,41,32,204
1,2,2,4,3,10,22
32,35,104,123,99,110,503
5,3,4,5,5,4,26
5,8,27,33,22,23,118
7,17,52,43,28,24,171
16,21,64,80,83,81,345
8,10,21,29,21,17,106
11,10,14,21,28,20,104
26,28,106,103,92,90,445
2,0,3,4,2,2,13
3,3,2,8,9,8,33
19,26,89,88,62,60,344
36,45,128,129,98,110,546
5,5,7,12,11,6,46
25,34,97,110,99,99,464
18,34,89,89,63,49,342
31,36,92,91,95,100,445
0,0,0,1,2,3,6
22,32,82,88,70,70,364
14,18,51,48,36,33,200
18,28,79,74,52,47,298
7,13,43,42,32,27,164
12,30,87,88,60,48,325
11,15,45,43,43,37,194
16,23,51,55,42,48,235
15,29,78,70,46,38,276
10,24,66,69,50,26,245
21,36,108,101,64,53,383
17,20,51,63,46,45,242
18,29,73,64,48,56,288
12,15,49,64,52,71,263
9,20,47,53,35,28,192
13,30,89,97,66,56,351
5,7,5,8,6,16,47
14,30,60,60,45,53,262
24,41,105,120,95,95,480
23,34,79,77,71,81,365
46,55,155,160,146,128,690
14,22,59,61,51,60,267
44,61,171,167,142,156,741
7,8,7,3,4,5,34
8,12,22,21,24,32,119
7,14,31,40,42,35,169
26,36,101,111,105,104,483
25,38,94,93,80,98,428
23,25,74,77,55,75,329
28,36,108,112,90,104,478
42,65,175,165,146,143,736
27,43,112,106,90,110,488
31,38,103,116,110,109,507
18,45,100,98,84,86,431
25,33,91,102,92,80,423
3,7,8,9,13,14,54
44,67,177,179,160,153,780
26,47,124,122,95,97,511
33,51,132,133,108,103,560
2,3,3,3,2,4,17
20,33,78,88,80,77,376
25,30,86,94,85,95,415
34,46,131,125,109,119,564
19,23,64,59,48,56,269
22,35,90,91,79,79,396
41,63,163,168,142,136,713
37,50,146,150,126,111,620
52,62,156,151,129,133,683
38,49,120,109,97,107,520
42,60,153,164,136,136,691
37,53,158,166,147,149,710
36,47,142,144,128,133,630
41,63,151,144,131,146,676
19,35,108,97,63,63,385
1,1,0,2,1,4,9
36,42,106,128,111,110,533
23,29,82,82,68,75,359
3,2,2,1,2,4,14
21,32,106,103,72,81,415
32,49,140,145,118,125,609
37,44,134,117,111,116,559
18,20,58,46,35,31,208
50,69,173,171,147,151,761
40,55,156,153,127,136,667
37,50,132,146,122,135,622
9,13,25,24,17,24,112
38,59,152,145,125,141,660
24,35,90,93,75,85,402
28,35,98,99,93,89,442
7,7,8,10,13,13,58
25,40,90,79,70,81,385
39,51,143,135,116,126,610
46,58,164,160,138,144,710
38,55,145,147,121,131,637
8,8,31,34,34,26,141
34,58,147,151,137,148,675
5,6,7,3,4,5,30
38,57,158,154,139,145,691
28,40,107,115,83,90,463
30,44,120,118,103,90,505
33,48,146,141,117,138,623
52,66,171,164,152,150,755
29,46,111,113,95,117,511
20,29,66,64,57,50,286
6,9,14,12,13,16,70
2,3,4,6,4,0,19
43,58,157,162,144,142,706
0,1,1,7,7,2,18
34,57,144,144,133,135,647
21,38,73,72,69,81,354
20,35,92,107,101,108,463
41,40,131,129,108,121,570
22,34,82,77,65,74,354
28,59,145,160,132,113,637
28,44,108,111,103,108,502
11,17,52,64,52,47,243
30,39,102,107,81,81,440
1,1,2,2,1,0,7
44,60,165,157,132,137,695
40,55,155,169,152,154,725
45,61,160,155,130,149,700
38,41,134,133,116,121,583
22,25,78,100,96,93,414
30,38,113,125,112,106,524
14,18,60,60,49,54,255
32,53,131,139,117,124,596
39,50,146,155,120,113,623
9,8,14,7,9,11,58
20,35,101,91,59,52,358
15,19,64,57,42,60,257
37,51,138,153,129,139,647
49,60,173,166,132,159,739
3,4,3,2,3,9,24
20,21,61,65,58,56,281
26,39,97,96,80,83,421
5,4,5,2,2,6,24
7,4,6,6,3,11,37
23,34,112,131,98,104,502
35,61,154,153,126,125,654
50,64,160,159,152,169,754
42,51,146,160,147,140,686
21,39,97,106,101,105,469
36,51,126,131,125,129,598
20,35,90,105,100,107,457
26,29,90,87,64,72,368
41,49,126,119,104,124,563
30,45,109,124,96,92,496
7,4,7,5,5,11,39
37,56,142,142,140,138,655
44,60,154,156,135,147,696
44,66,156,154,138,152,710
25,40,105,126,125,109,530
34,43,116,111,88,105,497
18,20,40,41,50,58,227
5,14,23,23,25,23,113
29,38,114,115,94,107,497
19,40,92,84,75,78,388
36,55,153,145,124,133,646
32,42,115,128,133,114,564
46,69,171,181,151,167,785
21,35,84,88,91,77,396
50,61,169,164,141,145,730
37,49,129,126,101,108,550
3,2,1,1,1,6,14
38,51,134,135,116,116,590
45,59,165,168,145,160,742
29,36,104,104,80,72,425
38,55,142,145,125,132,637
31,43,122,137,127,112,572
2,3,1,1,1,6,14
3,4,2,6,6,3,24
37,46,134,120,126,121,584
44,49,137,125,116,128,599
12,16,43,39,38,46,194
16,32,82,87,77,66,360
45,64,161,155,133,150,708
26,42,86,102,93,69,418
44,60,169,173,153,156,755
2,5,9,10,7,8,41
16,37,94,91,71,65,374
39,54,143,158,134,121,649
32,37,117,122,118,122,548
5,8,32,39,30,24,138
1,1,3,4,4,1,14
11,15,42,45,34,28,175
6,11,38,48,39,37,179
4,7,18,19,14,11,73
0,38,66,69,42,0,215
0,1,1,1,1,0,4
0,38,66,68,41,0,213
0,35,62,60,38,0,195
0,35,62,65,45,0,207
0,42,60,60,39,0,201
0,12,17,12,7,0,48
0,21,34,33,24,0,112
0,36,55,58,37,0,186
0,20,38,36,21,0,115
0,31,46,47,30,0,154
0,20,33,34,20,0,107
0,6,9,6,2,0,23
0,11,17,9,6,0,43
0,36,57,58,40,0,191
0,1,1,2,2,0,6
0,30,52,58,42,0,182
0,1,2,5,4,0,12
0,33,48,58,32,0,171
0,35,50,54,35,0,174
0,37,56,59,34,0,186
0,0,1,2,1,0,4
0,24,41,42,26,0,133
0,28,43,51,36,0,158
0,36,54,62,36,0,188
0,1,3,4,6,0,14
0,33,52,59,37,0,181
0,22,33,33,22,0,110
0,41,57,63,38,0,199
0,0,1,1,1,0,3
0,35,50,56,33,0,174
0,35,50,52,32,0,169
0,22,37,45,30,0,134
0,19,26,23,16,0,84
0,28,47,46,26,0,147
0,31,49,54,34,0,168
0,35,52,62,39,0,188
0,31,49,54,34,0,168
0,26,37,42,26,0,131
0,25,47,57,37,0,166
0,32,50,53,37,0,172
0,34,49,50,31,0,164
0,7,9,6,3,0,25
0,32,49,61,42,0,184
0,37,55,56,39,0,187
0,35,50,53,39,0,177
0,24,38,42,29,0,133
0,33,51,57,34,0,175
0,0,0,2,2,0,4
0,32,50,54,36,0,172
0,35,50,53,39,0,177
0,31,47,56,42,0,176
0,8,16,24,17,0,65
0,11,16,14,8,0,49
0,31,49,56,41,0,177
0,29,47,55,38,0,169
0,12,20,19,12,0,63
0,36,55,53,35,0,179
0,6,8,9,6,0,29
0,20,32,39,27,0,118
0,29,46,57,42,0,174
0,28,48,59,40,0,175
0,4,6,9,6,0,25
0,1,1,0,0,0,2
0,9,18,24,12,0,63
0,20,27,29,19,0,95
0,33,48,61,41,0,183
0,7,13,10,5,0,35
0,1,4,7,3,0,15
0,24,39,47,29,0,139
0,12,18,12,5,0,47
0,32,49,53,32,0,166
0,3,4,4,2,0,13
9,20,53,48,33,35,198
54,72,190,187,162,173,838
23,35,97,89,74,80,398
13,16,46,40,35,36,186
48,64,149,153,135,130,679
47,66,170,172,147,142,744
50,66,188,187,168,168,827
49,74,189,178,168,165,823
40,70,182,198,161,157,808
30,50,117,116,112,110,535
6,15,40,50,35,37,183
54,76,193,193,165,181,862
8,8,19,35,28,24,122
43,59,150,170,133,133,688
44,72,187,184,145,164,796
54,76,193,193,165,181,862
59,75,186,186,167,167,840
49,72,194,205,172,161,853
50,66,168,183,154,150,771
10,15,37,34,23,29,148
12,21,45,38,34,30,180
14,20,48,43,39,37,201
57,76,206,197,151,169,856
12,15,38,40,25,23,153
53,71,182,192,159,167,824
43,61,168,174,144,159,749
50,72,188,200,181,171,862
55,72,191,195,169,166,848
11,18,45,46,39,51,210
43,54,152,167,129,128,673
60,82,215,207,171,189,924
31,38,104,104,82,105,464
46,73,190,192,174,180,855
17,18,35,37,38,28,173
14,21,42,48,40,44,209
29,42,119,133,120,125,568
44,73,177,168,141,137,740
45,64,167,188,152,164,780
46,58,159,156,130,139,688
28,39,99,99,93,93,451
14,19,66,70,52,29,250
22,41,92,93,90,95,433
49,67,169,165,152,151,753
13,17,49,51,44,44,218
36,58,163,181,148,152,738
40,54,149,160,140,158,701
12,16,41,40,29,23,161
49,66,168,164,152,151,750
50,65,186,188,157,160,806
43,68,178,189,155,164,797
56,78,192,189,171,183,869
50,67,188,185,165,163,818
51,69,185,187,162,164,818
18,18,45,46,40,42,209
45,59,165,186,160,174,789
50,70,194,184,156,183,837
51,72,193,191,161,166,834
26,37,91,79,69,61,363
14,12,42,50,39,32,189
47,72,189,200,166,164,838
53,73,206,204,164,181,881
11,18,36,41,32,34,172
48,69,193,197,166,176,849
50,62,171,172,146,146,747
50,66,179,198,155,165,813
55,68,186,194,163,172,838
34,53,140,157,129,149,662
5,4,3,2,1,4,19
55,73,172,173,163,171,807
57,71,197,205,180,179,889
54,69,175,181,153,165,797
48,69,185,187,172,175,836
55,68,179,181,147,163,793
54,77,196,197,176,181,881
44,62,158,158,133,130,685
46,64,172,175,145,170,772
26,35,98,117,99,107,482
51,75,186,187,173,183,855
24,33,92,101,92,101,443
45,61,158,150,133,145,692
47,60,155,167,144,140,713
51,72,194,197,178,175,867
55,71,183,193,157,171,830
10,18,44,47,36,36,191
42,55,149,160,136,150,692
53,68,200,205,181,183,890
46,75,182,174,147,161,785
12,12,37,48,41,38,188
17,18,47,47,41,43,213
24,27,88,102,77,70,388
41,58,168,184,153,164,768
17,23,65,69,57,60,291
40,51,147,161,132,131,662
48,62,159,182,149,164,764
43,60,168,172,144,154,741
39,54,149,140,116,134,632
18,17,52,64,44,45,240
52,70,187,192,147,176,824
18,35,75,87,72,71,358
37,46,122,115,104,111,535
45,62,159,156,139,134,695
48,68,173,181,144,157,771
61,76,186,184,165,166,838
25,30,75,79,70,67,346
45,72,180,180,153,166,796
53,72,190,199,179,173,866
40,63,161,170,142,160,736
47,67,162,156,139,147,718
37,63,142,151,141,154,688
37,56,147,143,125,137,645
17,17,39,44,41,33,191
49,68,181,180,164,174,816
38,54,148,142,118,121,621
46,73,177,175,153,143,767
10,14,38,49,38,28,177
27,33,92,95,76,79,402
48,73,184,189,168,157,819
56,78,207,202,175,173,891
47,71,191,195,165,183,852
12,13,33,45,34,36,173
44,58,151,140,124,154,671
46,68,162,188,167,161,792
9,11,24,22,30,26,122
12,15,32,35,36,31,161
52,72,176,177,152,167,796
49,69,183,200,183,159,843
14,18,46,53,44,41,216
55,69,193,189,160,177,843
42,63,158,170,146,165,744
44,66,185,195,175,187,852
51,71,178,186,167,167,820
48,74,191,201,172,174,860
35,50,152,153,123,121,634
1,29,49,58,41,7,185
57,82,200,198,175,181,893
47,66,181,189,162,181,826
33,51,138,143,126,118,609
45,61,168,179,159,166,778
22,39,97,81,65,69,373
1,2,3,1,1,0,8
1,1,8,7,3,3,23
56,67,190,198,166,163,840
56,82,193,204,171,167,873
56,71,184,197,168,181,857
40,76,182,198,177,184,857
23,29,84,84,68,74,362
48,70,177,188,167,179,829
53,67,191,207,181,172,871
48,77,182,198,171,180,856
49,74,193,192,171,187,866
53,76,195,193,172,188,877
54,71,187,190,171,171,844
47,66,178,186,168,170,815
54,77,185,191,166,171,844
48,67,193,191,159,152,810
48,67,195,193,159,152,814
47,66,178,186,168,170,815
52,73,185,189,181,178,858
46,66,187,196,166,182,843
56,80,188,191,161,180,856
55,76,196,194,159,174,854
57,71,190,195,171,167,851
45,64,176,180,162,176,803
46,75,188,210,180,183,882
51,75,192,196,167,165,846
52,70,176,194,172,196,860
54,72,191,181,154,160,812
48,67,194,192,174,185,860
50,67,178,193,173,194,855
55,71,194,197,170,167,854
53,73,183,185,157,176,827
49,83,196,193,169,175,865
49,79,196,199,178,188,889
48,68,188,194,160,176,834
47,70,186,184,167,170,824
11,12,37,41,33,34,168
11,22,57,65,44,31,230
19,24,89,91,62,58,343
12,21,54,63,46,43,239
12,15,47,55,36,37,202
33,47,110,106,96,109,501
16,24,68,64,46,43,261
15,21,57,58,40,41,232
21,30,90,94,84,81,400
17,30,88,76,43,40,294
28,34,88,106,87,87,430
30,52,115,116,102,99,514
34,51,149,158,142,123,657
53,69,184,186,167,176,835
29,43,108,122,106,89,497
45,63,156,167,153,138,722
27,37,97,99,86,91,437
47,63,177,177,146,165,775
51,70,177,172,147,154,771
47,69,194,197,170,170,847
49,61,165,173,149,158,755
472,1234,2453,2480,1965,2468,11072
35,55,144,152,127,143,656
42,67,171,182,150,146,758
22,24,78,97,89,84,394
23,30,75,77,64,70,339
53,76,194,190,167,171,851
50,77,190,187,156,167,827
17,27,68,84,63,57,316
27,41,116,124,101,109,518
26,40,104,105,89,85,449
49,75,179,177,164,172,816
25,27,68,75,64,59,318
35,44,128,144,120,129,600
58,74,200,214,174,166,886
52,59,176,171,133,151,742
49,64,178,188,167,164,810
21,33,79,84,76,69,362
381,937,1907,1901,1482,1897,8505
34,40,105,110,103,114,506
59,77,192,187,170,181,866
37,60,154,158,131,134,674
30,43,97,105,95,106,476
24,29,66,65,58,69,311
30,35,89,98,91,100,443
31,43,88,91,81,84,418
39,58,153,151,149,145,695
33,31,117,121,107,109,518
56,80,182,199,171,166,854
14,18,56,72,55,55,270
21,42,92,94,92,97,438
42,62,166,171,142,152,735
37,52,123,117,110,109,548
27,50,128,147,134,125,611
42,66,171,181,171,175,806
48,65,200,204,177,173,867
15,23,72,85,67,64,326
22,40,114,117,113,110,516
36,30,104,118,88,93,469
43,62,155,157,143,151,711
50,64,187,169,154,161,785
24,33,74,69,55,64,319
53,74,184,170,152,152,785
47,62,180,175,171,171,806
56,69,189,184,169,159,826
45,66,186,186,155,172,810
53,74,202,185,157,178,849
32,45,117,121,116,127,558
42,49,145,160,133,130,659
43,56,165,157,141,123,685
34,48,119,118,102,110,531
24,33,96,103,89,73,418
39,56,151,145,126,123,640
28,37,104,109,114,115,507
20,32,79,87,75,73,366
28,46,125,130,116,111,556
55,65,181,189,164,169,823
21,27,77,86,77,79,367
51,67,179,174,158,161,790
12,18,57,59,51,57,254
48,66,187,188,149,170,808
37,56,149,145,127,121,635
29,37,93,107,93,105,464
32,48,113,120,97,101,511
45,49,135,137,131,131,628
50,68,165,162,147,153,745
41,60,156,155,136,152,700
47,52,143,153,135,142,672
37,51,124,129,113,113,567
23,32,102,116,104,110,487
23,33,90,96,86,91,419
37,54,152,160,126,132,661
36,53,147,158,140,135,669
41,51,177,185,138,143,735
51,68,174,166,142,166,767
40,62,158,166,133,148,707
31,45,113,125,114,91,519
51,67,176,175,157,162,788
39,65,168,173,152,167,764
54,86,201,207,166,163,877
33,36,97,101,79,83,429
55,78,194,202,173,172,874
49,62,174,183,165,155,788
35,54,144,153,128,141,655
42,57,149,152,138,138,676
31,34,93,95,86,83,422
25,35,82,87,77,67,373
34,40,96,104,83,93,450
39,48,136,149,125,119,616
35,51,143,156,135,150,670
49,75,193,182,161,167,827
6,5,4,1,2,5,23
28,44,121,114,100,114,521
35,50,130,142,123,139,619
39,48,137,137,129,139,629
39,58,133,126,109,115,580
40,36,104,103,90,105,478
43,54,151,147,130,136,661
31,52,125,127,82,108,525
35,41,117,110,111,105,519
29,46,110,117,94,103,499
3,3,5,9,7,7,34
35,46,127,132,123,117,580
43,59,153,154,141,147,697
45,68,180,177,170,172,812
32,51,127,129,103,101,543
25,46,114,109,92,96,482
33,43,112,116,103,103,510
22,43,99,109,93,94,460
35,49,149,155,140,123,651
16,30,70,83,67,64,330
23,34,97,85,70,78,387
22,29,85,72,59,68,335
18,25,69,64,59,64,299
20,33,73,64,62,80,332
28,52,134,120,99,114,547
52,63,186,193,169,164,827
47,69,177,181,161,157,792
11,20,56,61,51,59,258
46,69,188,201,177,173,854
43,56,142,143,125,130,639
45,67,179,176,153,156,776
50,74,204,205,173,174,880
32,50,126,143,120,129,600
41,68,158,160,132,139,698
49,70,212,218,178,199,926
998,2727,5429,5460,4393,5390,24397
36,51,124,125,110,116,562
50,74,186,181,160,172,823
46,64,186,189,159,165,809
48,67,179,171,155,163,783
44,68,187,191,167,182,839
54,73,203,204,167,177,878
5,4,4,3,1,4,21
44,62,140,137,129,142,654
56,78,200,190,171,168,863
43,67,173,183,162,163,791
33,47,124,129,119,109,561
33,53,142,145,128,131,632
47,60,175,183,156,157,778
29,56,140,155,122,132,634
47,70,183,183,163,169,815
48,73,193,178,166,168,826
46,64,176,186,158,160,790
34,56,142,141,123,134,630
0,35,66,63,38,0,202
36,48,127,147,120,122,600
43,60,147,144,140,149,683
31,51,130,136,124,119,591
54,69,199,194,167,183,866
40,67,167,157,145,145,721
55,75,199,191,171,183,874
46,74,195,205,177,186,883
40,52,131,140,128,138,629
40,71,178,173,158,174,794
41,47,129,131,119,116,583
44,62,164,189,170,162,791
48,68,185,184,168,179,832
122,209,496,506,438,506,2277
30,48,124,113,105,124,544
55,70,186,179,159,169,818
46,58,157,148,129,139,677
49,72,182,182,157,164,806
40,53,140,130,119,125,607
32,42,115,127,98,99,513
44,62,160,187,171,168,792
58,73,194,190,171,179,865
21,24,55,47,43,64,254
46,75,193,191,162,154,821
43,67,171,181,157,149,768
53,66,200,206,164,183,872
45,77,185,190,162,178,837
37,51,137,129,112,124,590
43,66,175,167,152,155,758
45,64,167,179,159,169,783
49,71,175,171,156,162,784
51,73,204,196,183,172,879
46,66,177,184,163,170,806
1,37,62,60,35,0,195
46,70,179,164,146,144,749
48,74,193,180,168,168,831
44,62,167,168,152,151,744
42,51,134,147,111,120,605
15,40,94,88,67,41,345
48,66,187,179,151,157,788
49,76,189,182,160,171,827
39,56,128,125,108,112,568
32,36,102,107,99,96,472
45,62,153,160,151,149,720
27,44,129,143,119,128,590
30,33,102,113,105,107,490
34,54,133,143,121,121,606
40,63,192,199,158,158,810
39,56,135,142,121,106,599
49,68,163,170,150,140,740
48,83,195,183,158,173,840
42,60,147,146,134,146,675
47,77,192,179,154,181,830
51,69,180,184,171,167,822
38,54,143,146,110,111,602
36,50,127,130,119,120,582
47,61,169,177,157,146,757
0,34,68,71,44,0,217
50,68,185,193,173,164,833
22,27,85,84,67,66,351
36,48,121,115,106,122,548
59,72,205,217,190,204,947
11,22,59,61,62,58,273
6,42,81,77,46,22,274
15,26,66,65,52,48,272
41,66,170,171,141,141,730
2,35,64,81,42,4,228
0,41,70,67,40,0,218
15,26,64,67,61,49,282
31,43,123,112,99,103,511
40,56,144,122,111,122,595
41,59,145,148,136,143,672
47,65,183,188,167,166,816
44,64,164,170,145,136,723
10,29,89,81,50,37,296
17,25,61,71,53,51,278
52,64,173,173,145,157,764
29,49,131,132,91,80,512
0,37,68,73,37,0,215
20,21,61,66,44,48,260
17,21,66,60,54,56,274
17,23,66,67,54,52,279
45,64,159,166,159,161,754
48,71,171,176,149,158,773
52,65,164,177,158,158,774
25,47,110,114,98,121,515
23,40,131,119,72,65,450
23,33,100,90,67,82,395
14,43,109,114,71,40,391
12,22,60,65,53,51,263
33,56,128,126,111,109,563
16,23,60,64,50,52,265
14,22,61,68,53,57,275
53,62,174,177,160,159,785
48,65,170,157,145,149,734
0,37,77,81,44,0,239
33,48,154,135,95,102,567
21,28,63,62,57,52,283
32,53,133,131,116,131,596
43,61,158,171,140,156,729
46,62,164,171,145,142,730
43,58,167,171,149,145,733
41,58,144,146,133,135,657
47,59,173,180,163,161,783
0,33,61,71,44,0,209
45,63,151,157,136,158,710
51,65,176,183,171,164,810
43,64,146,146,132,130,661
43,64,168,174,158,153,760
16,23,65,71,57,47,279
14,24,61,69,52,49,269
0,37,71,60,35,0,203
17,20,57,63,55,58,270
45,55,159,163,140,137,699
20,20,68,71,54,51,284
20,36,110,113,85,70,434
3,39,73,74,50,12,251
40,63,162,165,148,158,736
25,27,77,86,71,76,362
15,22,55,53,51,51,247
16,25,68,80,56,60,305
43,58,137,139,139,133,649
46,68,173,168,155,157,767
29,48,119,140,119,129,584
40,45,135,148,137,133,638
46,66,173,171,149,153,758
51,70,173,163,147,162,766
26,44,106,117,94,107,494
25,39,123,127,79,72,465
46,63,166,177,151,155,758
56,67,195,192,157,170,837
52,65,164,177,158,158,774
13,20,53,64,60,60,270
19,41,125,116,72,60,433
34,53,151,153,118,124,633
23,34,106,104,67,67,401
55,72,174,173,156,162,792
36,51,127,154,125,114,607
17,32,99,99,59,51,357
17,20,64,62,50,59,272
48,65,178,183,173,163,810
46,65,180,173,149,158,771
20,29,84,98,80,69,380
49,67,179,162,150,160,767
44,65,171,178,160,145,763
9,35,85,75,41,22,267
38,53,129,130,116,119,585
48,70,182,179,157,176,812
16,24,63,58,47,44,252
44,61,173,183,154,153,768
0,43,69,65,38,0,215
51,74,187,184,171,169,836
0,31,69,79,44,0,223
17,25,74,73,50,53,292
13,18,50,60,51,46,238
45,58,156,163,140,143,705
33,40,119,131,114,114,551
0,42,81,71,40,0,234
0,45,64,62,44,0,215
14,21,61,62,44,56,258
13,22,64,55,52,56,262
0,37,69,60,39,0,205
55,67,208,201,172,180,883
32,50,121,125,98,126,552
0,39,75,73,46,0,233
53,68,181,188,170,169,829
19,23,59,47,38,50,236
31,36,101,104,94,99,465
0,43,74,75,39,0,231
45,58,156,165,153,159,736
23,29,91,88,74,81,386
52,74,173,175,161,160,795
51,69,188,200,170,164,842
1,37,67,76,50,2,233
0,40,74,83,48,0,245
51,67,174,177,167,158,794
41,53,144,153,138,141,670
30,44,116,125,108,106,529
33,56,132,127,104,102,554
8,39,70,78,48,23,266
37,52,137,153,132,130,641
43,60,150,155,139,143,690
27,45,114,114,95,107,502
0,37,57,63,39,0,196
32,47,126,136,115,120,576
46,73,191,211,189,186,896
14,25,64,70,49,49,271
18,26,69,80,51,50,294
26,38,77,89,71,68,369
21,35,83,92,77,84,392
50,73,187,180,166,178,834
51,69,197,202,171,184,874
15,21,45,50,40,29,200
53,75,195,188,157,160,828
55,77,208,216,176,186,918
18,23,66,78,57,58,300
19,28,72,82,50,50,301
17,22,55,53,35,47,229
50,60,178,193,173,167,821
56,79,204,202,171,175,887
14,22,49,51,40,43,219
47,69,165,185,149,147,762
38,54,148,155,138,139,672
12,22,41,47,43,42,207
18,16,44,52,38,31,199
17,24,48,60,55,45,249
22,23,72,80,64,52,313
20,27,56,57,42,45,247
17,26,71,70,50,57,291
57,78,186,195,171,193,880
58,80,209,215,170,167,899
14,27,62,64,48,60,275
53,68,181,186,153,170,811
42,65,167,178,149,153,754
49,81,204,197,165,180,876
58,77,196,191,168,170,860
16,24,57,56,43,45,241
12,23,46,54,42,46,223
15,23,57,55,48,46,244
17,30,69,68,49,44,277
52,68,180,186,153,170,809
16,31,70,68,50,48,283
16,31,70,68,50,48,283
36,51,123,127,113,124,574
54,72,190,194,163,162,835
61,90,207,203,179,188,928
10,19,44,54,41,37,205
19,22,64,64,46,57,272
15,22,55,64,53,55,264
59,79,207,199,160,174,878
17,21,54,67,42,46,247
54,72,209,224,173,178,910
28,53,112,121,107,101,522
37,52,135,155,127,135,641
16,25,50,56,46,38,231
53,80,199,191,171,181,875
53,69,176,196,168,172,834
55,63,222,213,183,179,915
51,70,213,212,168,179,893
50,64,189,197,161,177,838
54,70,194,196,165,175,854
18,21,66,66,59,54,284
63,89,202,201,190,195,940
50,72,205,198,163,170,858
54,76,176,170,164,172,812
30,46,111,113,97,110,507
53,73,200,205,159,182,872
15,20,56,58,48,52,249
35,47,111,106,105,114,518
52,78,176,180,171,171,828
53,75,198,208,184,209,927
17,31,71,72,49,45,285
48,73,193,203,175,189,881
18,22,55,64,56,56,271
16,21,45,51,48,47,228
40,56,171,174,151,161,753
51,75,198,189,166,188,867
55,79,198,204,162,172,870
21,32,93,99,85,74,404
19,23,64,73,52,55,286
54,78,201,198,176,172,879
50,60,162,165,156,164,757
55,79,209,198,164,170,875
54,74,197,194,171,188,878
13,23,46,51,35,32,200
15,18,51,61,39,40,224
16,25,55,61,49,50,256
16,22,57,58,52,43,248
12,19,50,55,52,40,228
50,68,200,201,166,181,866
18,23,69,79,57,53,299
27,41,115,123,105,94,505
57,79,195,194,168,175,868
15,21,53,56,41,50,236
59,77,197,188,167,171,859
21,22,65,60,51,43,262
14,20,51,52,39,41,217
48,73,192,201,170,179,863
60,76,200,202,181,173,892
19,24,57,67,60,51,278
26,42,112,120,97,95,492
23,39,105,98,91,107,463
14,20,47,56,41,44,222
18,25,50,53,46,42,234
39,57,135,132,119,119,601
53,73,202,198,170,180,876
33,45,142,155,135,135,645
17,27,66,85,76,79,350
13,22,44,49,41,42,211
19,30,69,67,53,59,297
16,18,51,67,42,56,250
53,71,183,194,165,177,843
40,55,141,121,110,120,587
56,68,174,184,165,194,841
54,72,194,211,161,175,867
49,76,182,165,138,151,761
47,69,166,171,156,157,766
54,76,206,201,164,168,869
52,77,204,211,171,172,887
45,62,185,182,158,174,806
53,71,185,188,172,181,850
11,19,51,59,42,50,232
13,14,41,45,39,31,183
51,72,183,191,166,168,831
53,73,210,207,159,172,874
49,68,201,200,169,177,864
61,80,195,201,172,175,884
49,72,194,190,166,166,837
59,77,202,201,159,166,864
49,73,189,184,158,171,824
46,65,175,189,162,167,804
16,20,57,65,50,56,264
37,56,139,156,141,143,672
57,80,200,211,179,178,905
15,27,56,61,42,49,250
13,18,45,50,42,43,211
14,21,48,56,40,43,222
49,67,190,186,160,157,809
59,80,205,197,151,163,855
48,71,173,181,154,173,800
54,67,181,189,171,187,849
53,73,203,221,176,167,893
57,87,211,218,189,193,955
54,77,186,192,154,170,833
52,71,196,199,169,165,852
13,16,44,35,32,33,173
11,18,45,44,34,27,179
52,73,201,211,163,168,868
49,67,202,220,173,191,902
13,19,46,52,46,39,215
52,76,187,203,158,168,844
60,74,204,227,197,175,937
53,81,193,197,175,186,885
57,75,203,213,169,177,894
15,17,49,54,41,37,213
42,62,178,179,155,164,780
18,23,52,62,47,46,248
50,79,206,204,169,165,873
54,73,195,190,164,171,847
12,22,49,53,40,43,219
58,76,198,195,167,174,868
49,72,194,204,162,176,857
48,69,195,206,169,187,874
48,72,187,200,173,167,847
50,76,183,207,167,178,861
16,23,52,56,44,39,230
52,77,202,205,168,186,890
55,79,203,191,156,168,852
42,69,196,190,155,167,819
49,66,197,197,162,180,851
56,78,201,205,178,182,900
54,74,189,191,166,182,856
55,85,210,218,189,195,952
51,73,195,212,163,178,872
51,66,192,208,161,171,849
14,21,54,61,40,44,234
55,71,203,209,168,182,888
54,82,204,207,178,190,915
52,76,203,212,171,178,892
51,78,204,203,165,174,875
11,18,47,45,40,50,211
55,73,202,214,174,180,898
9,20,49,54,42,44,218
14,21,51,58,50,47,241
54,70,180,177,160,190,831
33,56,134,138,122,122,605
53,74,186,194,162,168,837
44,55,141,144,130,131,645
10,24,53,61,57,55,260
20,25,84,69,52,77,327
12,23,55,52,30,20,192
27,53,126,137,131,132,606
43,56,132,143,121,135,630
44,68,182,182,165,149,790
41,53,149,146,119,122,630
48,51,145,148,128,114,634
39,55,159,160,142,149,704
42,52,148,152,125,130,649
11,11,40,39,21,23,145
12,17,65,68,50,29,241
14,14,57,54,41,38,218
30,37,93,96,100,98,454
19,26,96,98,60,47,346
2,1,4,2,0,2,11
36,52,128,133,119,127,595
40,63,155,144,127,147,676
24,36,99,99,96,86,440
33,43,112,122,117,105,532
45,52,172,178,148,158,753
0,36,55,60,33,0,184
48,69,182,185,166,185,835
46,67,173,174,145,157,762
32,47,133,143,122,116,593
31,48,133,134,120,129,595
37,52,138,150,124,138,639
22,37,97,114,93,102,465
36,48,133,142,115,120,594
39,64,168,166,147,135,719
28,40,126,135,130,124,583
2,4,3,3,4,8,24
46,59,161,162,139,129,696
19,29,73,65,62,69,317
28,38,101,102,86,81,436
18,28,71,88,83,86,374
23,32,86,82,76,97,396
1,2,4,7,4,7,25
38,57,155,149,128,138,665
53,61,164,160,143,141,722
33,46,111,120,98,103,511
36,53,147,133,116,129,614
36,47,120,122,90,101,516
29,45,89,94,93,94,444
22,36,91,99,91,83,422
26,38,119,126,110,102,521
48,60,157,145,119,137,666
33,48,126,121,104,112,544
31,48,121,118,108,101,527
29,47,122,130,108,118,554
32,38,101,109,92,90,462
34,52,143,142,129,145,645
26,43,123,136,123,105,556
50,68,170,152,135,138,713
46,65,178,172,150,152,763
37,49,131,137,124,125,603
47,60,163,148,131,143,692
40,61,165,154,131,144,695
3,7,6,4,4,3,27
20,20,49,61,50,51,251
34,53,145,147,123,134,636
15,19,51,61,55,54,255
45,63,152,159,155,154,728
36,50,141,145,127,121,620
41,59,164,162,139,141,706
48,61,163,159,146,150,727
44,58,175,190,155,161,783
23,35,88,96,83,96,421
52,73,180,198,167,167,837
35,53,125,117,102,95,527
52,72,193,189,165,152,823
28,45,97,98,99,100,467
13,22,73,84,82,91,365
26,35,92,95,79,92,419
36,63,160,143,133,143,678
34,42,124,129,109,100,538
43,59,163,153,123,126,667
39,56,148,148,132,126,649
33,45,131,141,115,122,587
2,1,4,5,3,4,19
28,34,75,80,82,87,386
45,52,152,151,134,123,657
43,64,176,170,151,148,752
33,43,113,118,101,108,516
42,63,176,169,143,141,734
31,44,108,117,103,88,491
44,63,178,199,165,169,818
1,3,3,4,4,2,17
41,53,157,179,160,150,740
44,62,161,159,141,143,710
38,52,133,131,118,114,586
38,52,152,157,135,148,682
39,53,141,145,124,142,644
46,67,183,179,158,156,789
40,51,148,147,130,144,660
46,61,175,168,141,149,740
35,46,108,110,90,86,475
28,42,114,117,87,94,482
46,70,171,178,145,144,754
38,49,149,141,125,135,637
33,38,115,105,92,101,484
49,66,167,166,142,156,746
47,72,184,186,158,161,808
25,40,103,102,89,73,432
20,22,55,56,53,54,260
44,68,170,167,139,153,741
38,61,153,146,142,135,675
18,20,68,69,51,43,269
43,61,153,146,122,141,666
26,35,90,94,81,71,397
23,24,72,89,86,83,377
25,34,96,92,87,101,435
51,71,188,187,186,204,887
49,63,179,186,159,163,799
53,68,181,202,165,161,830
0,28,57,75,41,0,201
35,53,128,125,121,138,600
36,55,131,128,114,105,569
23,32,80,81,76,78,370
55,76,194,202,170,166,863
49,67,187,192,166,160,821
19,30,70,93,75,68,355
52,74,195,185,147,164,817
44,68,187,198,180,170,847
34,42,109,125,109,107,526
43,66,190,202,170,168,839
51,69,182,189,168,166,825
55,63,174,173,152,146,763
0,41,56,62,39,0,198
50,72,181,182,163,168,816
52,72,204,188,163,176,855
37,52,144,167,141,147,688
52,76,186,181,159,160,814
45,67,182,198,177,167,836
0,43,61,66,41,0,211
30,46,120,129,115,117,557
51,70,169,174,159,148,771
0,43,76,66,38,0,223
53,74,178,175,151,168,799
49,72,189,201,168,174,853
48,61,173,179,171,160,792
48,67,183,185,170,174,827
43,63,164,158,137,142,707
45,65,156,168,154,160,748
53,67,186,185,167,188,846
52,74,178,186,168,152,810
42,52,152,163,153,156,718
0,42,66,78,42,0,228
42,55,175,173,144,160,749
52,78,197,192,166,164,849
0,40,70,77,43,0,230
54,79,202,202,173,174,884
52,76,194,198,166,180,866
44,56,149,157,142,134,682
52,74,189,198,167,168,848
54,67,197,203,174,188,883
0,39,63,74,45,0,221
42,62,154,169,151,140,718
0,41,78,78,43,0,240
47,63,161,165,152,162,750
0,36,63,68,37,0,204
44,57,129,137,137,138,642
47,64,185,201,169,170,836
48,69,176,172,157,173,795
54,74,205,190,171,177,871
47,59,146,158,142,139,691
53,77,195,192,167,182,866
49,75,193,190,169,169,845
43,58,160,165,143,149,718
0,39,62,63,41,0,205
43,65,178,182,151,153,772
0,43,61,68,35,0,207
43,66,172,176,146,154,757
0,45,70,69,36,0,220
0,45,69,74,44,0,232
46,73,206,195,163,165,848
50,76,180,188,169,161,824
48,63,168,165,147,159,750
47,69,170,165,152,146,749
49,65,184,193,163,174,828
39,50,138,134,118,126,605
43,65,176,182,152,153,771
41,56,151,164,139,146,697
0,0,0,1,1,0,2
58,79,185,188,172,192,874
23,37,93,101,91,75,420
29,48,120,136,117,131,581
49,65,164,155,131,148,712
49,70,172,170,147,151,759
53,72,198,198,177,184,882
58,141,308,313,234,275,1329
41,60,152,154,133,142,682
41,53,140,144,118,126,622
38,54,143,135,115,125,610
18,25,67,65,55,77,307
45,64,175,180,155,165,784
21,29,78,72,69,63,332
17,27,67,62,48,59,280
35,45,117,112,89,112,510
41,60,160,164,143,147,715
38,52,147,151,131,143,662
40,49,141,142,117,130,619
51,71,186,189,158,164,819
51,73,197,202,169,172,864
40,60,164,158,134,143,699
35,52,129,125,109,121,571
30,52,140,149,133,128,632
40,54,162,148,115,103,622
37,54,130,135,125,143,624
24,39,123,129,116,112,543
36,57,146,149,120,138,646
33,48,125,123,103,126,558
31,52,140,148,119,120,610
36,50,153,145,121,117,622
42,62,167,151,132,144,698
40,49,137,122,106,116,570
14,29,55,59,57,49,263
39,58,147,146,117,124,631
32,43,132,140,114,117,578
23,43,93,107,100,101,467
47,65,169,193,170,174,818
35,43,102,101,83,82,446
43,66,165,161,146,154,735
45,69,178,167,148,165,772
46,52,160,162,132,138,690
28,41,112,120,101,106,508
33,40,96,85,90,95,439
26,35,112,110,93,99,475
22,34,92,89,69,83,389
24,29,87,91,79,76,386
26,43,82,92,82,82,407
21,34,81,89,83,82,390
21,34,81,89,83,82,390
22,33,93,88,71,87,394
20,33,82,72,55,70,332
24,34,73,63,67,63,324
3,4,1,6,5,2,21
21,24,55,71,68,63,302
25,33,85,85,64,66,358
42,55,141,154,134,143,669
6,4,2,3,3,2,20
34,43,109,112,99,110,507
24,45,105,103,92,83,452
27,44,108,118,108,90,495
25,37,81,90,88,83,404
15,20,63,75,69,62,304
41,52,144,137,129,148,651
30,39,116,119,108,101,513
33,54,134,134,112,115,582
30,43,96,95,86,101,451
14,28,60,56,44,46,248
34,43,114,120,97,115,523
20,25,60,64,58,56,283
1,1,1,2,4,5,14
17,19,44,47,48,44,219
21,30,70,74,63,59,317
49,65,170,172,146,164,766
48,68,176,187,160,157,796
43,64,170,154,136,135,702
23,33,73,84,80,57,350
21,22,68,69,59,64,303
21,22,68,69,59,64,303
50,65,209,210,177,185,896
49,67,174,185,154,176,805
52,69,193,188,172,182,856
52,73,192,201,174,165,857
43,66,171,172,153,146,751
40,65,172,177,155,157,766
50,67,200,196,166,170,849
59,71,199,196,166,169,860
50,69,182,207,178,193,879
29,46,126,123,109,115,548
47,59,188,199,170,174,837
34,52,133,135,121,134,609
38,52,149,149,131,123,642
39,62,155,163,139,135,693
16,35,88,85,74,87,385
41,58,157,150,132,141,679
42,59,160,170,147,132,710
26,42,111,122,110,110,521
37,51,127,129,108,118,570
29,38,121,124,110,116,538
29,38,121,124,110,116,538
37,57,151,153,135,142,675
36,59,147,149,125,126,642
21,39,88,93,84,84,409
29,38,87,69,65,61,349
35,49,141,148,126,128,627
39,59,165,169,146,149,727
39,60,159,163,136,143,700
44,61,158,156,139,139,697
55,67,202,198,165,167,854
47,64,187,195,163,169,825
29,44,104,105,91,90,463
31,43,90,94,98,112,468
51,73,185,188,163,172,832
47,71,189,200,167,178,852
27,42,95,98,87,92,441
32,44,118,120,96,103,513
34,46,119,123,106,111,539
32,38,104,116,94,112,496
49,68,196,193,166,167,839
40,59,152,150,133,153,687
42,59,169,160,124,131,685
41,64,167,172,159,172,775
26,50,112,114,100,100,502
34,46,146,126,93,97,542
47,63,172,167,141,159,749
36,54,149,150,133,133,655
21,31,79,81,72,82,366
36,45,130,135,130,129,605
26,36,99,97,83,101,442
37,55,142,134,130,133,631
37,59,139,137,129,136,637
39,59,158,169,145,148,718
44,64,180,181,163,161,793
35,58,145,166,139,149,692
48,72,199,201,171,179,870
51,76,202,198,168,174,869
58,70,200,190,160,171,849
44,65,177,189,171,177,823
41,53,153,140,105,120,612
46,65,197,209,174,178,869
55,78,195,192,164,173,857
48,63,166,172,159,173,781
46,64,177,174,157,166,784
50,61,174,175,147,147,754
53,68,191,186,163,178,839
50,63,167,171,140,154,745
45,60,159,158,136,139,697
56,75,188,182,167,172,840
48,70,185,170,154,148,775
41,50,142,158,137,149,677
56,75,192,192,162,166,843
52,73,184,177,152,165,803
40,61,157,168,142,142,710
44,52,156,171,145,147,715
31,50,133,151,127,115,607
42,54,148,143,127,131,645
37,48,120,122,107,114,548
46,69,186,182,160,162,805
52,64,173,160,154,160,763
52,70,186,193,168,169,838
40,61,149,147,135,134,666
36,48,130,130,107,118,569
49,67,193,202,182,173,866
49,78,195,187,168,164,841
50,78,210,209,168,182,897
45,68,174,182,157,150,776
45,68,174,182,157,150,776
46,67,184,174,147,150,768
48,67,182,179,168,169,813
51,80,196,181,159,157,824
52,78,197,182,157,170,836
47,72,179,172,152,143,765
49,79,189,191,170,173,851
58,81,197,198,188,190,912
31,43,119,121,108,103,525
53,75,198,194,173,179,872
31,46,118,124,114,117,550
60,76,196,207,177,188,904
56,74,190,186,170,173,849
46,71,184,167,151,160,779
47,78,207,188,171,183,874
33,56,151,148,132,149,669
50,68,187,197,169,166,837
53,68,192,203,174,183,873
60,78,218,193,161,161,871
53,77,196,192,172,186,876
46,70,189,187,165,184,841
19,27,73,75,56,63,313
46,62,172,190,168,158,796
52,79,197,193,168,183,872
55,75,193,195,171,186,875
47,72,171,178,155,171,794
48,71,191,189,170,178,847
52,72,189,192,173,177,855
51,60,181,197,171,161,821
43,65,159,175,159,159,760
46,65,174,184,161,148,778
47,65,193,198,165,180,848
42,66,174,183,163,156,784
45,66,180,189,166,164,810
45,66,166,163,145,152,737
46,72,182,188,164,160,812
46,68,173,182,164,186,819
41,53,148,160,135,139,676
47,64,176,186,162,173,808
44,65,175,178,161,174,797
46,63,168,170,150,158,755
44,69,181,183,157,170,804
40,59,148,152,123,129,651
38,49,145,152,133,129,646
14,21,49,42,41,53,220
49,74,192,190,175,167,847
416,1037,2124,2113,1661,2099,9450
42,48,121,124,111,125,571
40,49,149,146,116,119,619
52,67,197,196,167,176,855
37,49,140,160,141,153,680
42,52,153,162,141,160,710
46,63,153,163,147,137,709
45,59,161,162,145,145,717
43,62,163,156,130,143,697
37,54,144,162,142,146,685
47,61,153,160,147,152,720
41,52,147,167,145,154,706
42,62,153,158,148,154,717
46,70,179,165,147,144,751
13,24,66,64,53,61,281
27,37,110,113,107,114,508
29,41,119,116,96,111,512
31,48,125,115,90,99,508
27,40,113,117,101,124,522
31,51,124,120,113,126,565
35,53,118,125,113,119,563
31,39,105,101,93,104,473
50,68,191,187,159,175,830
45,76,191,188,176,176,852
45,61,174,177,162,175,794
44,67,172,159,141,136,719
47,74,178,177,153,154,783
46,60,167,186,165,151,775
27,42,114,114,103,102,502
22,54,116,117,98,87,494
47,72,192,194,167,172,844
45,70,201,205,178,191,890
44,74,193,191,164,165,831
24,31,82,70,70,66,343
54,80,204,186,170,177,871
55,77,205,189,164,184,874
49,64,187,188,164,166,818
48,65,186,195,165,176,835
50,74,198,211,186,184,903
45,69,199,189,174,175,851
49,67,193,194,174,169,846
44,68,180,182,155,161,790
48,67,179,186,151,161,792
487,1315,2642,2674,2174,2577,11869
353,799,1656,1633,1311,1585,7337
51,73,196,199,177,186,882
0,36,69,71,39,0,215
35,51,150,156,132,150,674
0,35,67,66,47,0,215
0,30,63,69,44,0,206
0,32,69,63,44,0,208
0,40,67,68,37,0,212
47,68,195,195,161,159,825
40,57,165,159,142,124,687
50,67,181,189,169,152,808
46,70,190,195,165,159,825
44,60,154,166,142,145,711
49,78,189,188,168,166,838
0,42,66,63,40,0,211
43,69,173,180,159,156,780
44,64,161,172,157,151,749
43,57,154,165,143,157,719
47,59,150,159,146,154,715
51,71,202,197,178,169,868
53,78,189,190,172,169,851
49,67,171,176,160,156,779
49,60,185,174,152,168,788
54,69,171,165,145,148,752
44,65,163,173,157,162,764
42,60,163,163,136,136,700
39,49,140,138,120,141,627
45,65,172,177,147,145,751
45,58,164,171,137,137,712
56,69,189,193,176,181,864
48,72,170,173,161,157,781
47,59,157,184,155,164,766
58,68,182,194,177,174,853
55,70,186,192,176,176,855
52,67,188,202,176,174,859
40,66,186,200,175,142,809
41,66,183,202,181,151,824
48,67,191,182,164,177,829
55,70,192,208,178,173,876
51,71,189,192,157,163,823
45,60,194,192,170,185,846
45,71,200,198,169,161,844
52,76,198,188,169,163,846
0,40,66,67,40,0,213
0,40,66,67,40,0,213
0,46,61,74,38,0,219
52,74,185,195,169,170,845
54,74,184,202,175,171,860
51,67,181,189,167,169,824
45,64,191,195,165,160,820
52,65,195,192,175,176,855
46,74,185,180,152,156,793
46,70,177,182,164,169,808
39,56,152,159,138,144,688
45,60,168,173,149,156,751
46,63,163,180,169,158,779
56,75,176,179,157,175,818
56,75,176,180,159,175,821
55,73,181,189,166,169,833
40,60,176,175,150,162,763
49,68,191,189,181,169,847
49,67,176,189,166,170,817
46,69,171,173,160,167,786
51,70,179,176,164,163,803
44,59,151,153,130,149,686
56,71,199,196,162,173,857
54,61,171,176,160,155,777
56,64,161,169,158,154,762
52,67,182,179,156,168,804
25,30,90,99,91,77,412
43,57,135,156,136,139,666
51,65,173,172,150,138,749
34,61,149,148,123,139,654
38,49,132,132,123,130,604
42,59,147,153,138,142,681
56,76,200,177,153,171,833
51,68,200,184,154,166,823
46,69,171,172,159,144,761
47,65,167,168,154,150,751
52,68,202,194,161,160,837
50,75,186,201,176,179,867
48,74,183,185,160,153,803
35,44,118,125,96,108,526
37,49,133,131,115,109,574
52,70,195,195,165,180,857
39,58,137,137,109,107,587
39,52,138,138,118,124,609
36,46,128,123,118,132,583
0,39,65,68,40,0,212
0,39,70,73,41,0,223
54,72,203,203,169,181,882
52,73,197,195,170,187,874
55,67,196,206,170,166,860
56,74,207,205,171,162,875
56,74,207,205,171,162,875
48,70,200,192,170,167,847
50,69,185,189,178,178,849
54,63,183,181,166,167,814
53,75,206,203,171,181,889
23,34,103,103,86,86,435
53,66,203,212,185,204,923
45,61,154,160,147,150,717
52,72,203,202,180,187,896
28,44,102,97,80,90,441
0,40,63,67,30,0,200
0,40,58,64,38,0,200
47,62,191,192,179,174,845
0,41,65,71,38,0,215
0,44,64,76,42,0,226
34,53,154,154,130,133,658
12,35,84,79,64,40,314
12,35,88,77,62,48,322
34,56,168,165,156,131,710
0,30,60,62,40,0,192
0,44,63,73,42,0,222
52,70,190,183,162,168,825
51,69,194,196,170,156,836
22,32,75,71,64,77,341
48,68,173,176,154,158,777
45,66,176,185,154,155,781
0,41,59,71,38,0,209
0,36,53,72,40,0,201
0,38,78,77,38,0,231
0,39,62,68,39,0,208
0,41,65,64,36,0,206
0,38,61,71,45,0,215
51,70,210,213,184,191,919
0,33,58,63,38,0,192
53,72,197,204,183,189,898
55,72,202,208,188,185,910
45,57,166,179,153,158,758
47,59,149,150,142,143,690
0,38,58,66,40,0,202
48,73,195,195,166,167,844
33,50,127,136,114,110,570
56,80,192,189,166,154,837
51,67,187,193,167,175,840
17,24,60,68,56,48,273
50,68,193,194,168,183,856
55,69,184,179,155,154,796
51,69,169,171,152,152,764
48,63,170,169,152,162,764
30,48,118,128,107,110,541
23,37,96,97,88,82,423
43,60,173,182,161,160,779
54,66,176,179,162,160,797
30,46,123,117,94,102,512
15,24,62,63,60,52,276
22,24,85,89,79,73,372
17,29,83,92,77,59,357
16,22,60,62,49,45,254
0,39,78,63,39,0,219
17,24,60,69,53,44,267
44,58,150,160,138,145,695
33,29,95,75,71,87,390
43,58,150,152,132,142,677
48,69,177,175,158,162,789
0,36,63,71,45,7,222
49,69,188,191,163,170,830
30,50,125,134,96,82,517
3,39,68,74,41,4,229
54,64,176,181,162,161,798
50,68,194,198,174,168,852
0,33,68,71,43,0,215
14,23,64,62,50,50,263
24,31,97,111,100,92,455
40,53,149,158,139,145,684
27,44,99,95,75,73,413
1,38,55,53,39,7,193
54,76,210,217,194,196,947
54,75,186,201,171,187,874
48,71,188,220,186,196,909
16,28,70,67,52,48,281
17,23,60,46,39,59,244
13,20,45,46,43,27,194
13,22,51,58,42,44,230
60,76,202,201,172,184,895
47,63,171,164,151,161,757
23,17,64,53,51,55,263
19,28,64,61,49,55,276
54,82,189,194,151,159,829
31,43,123,114,101,107,519
54,71,200,198,175,180,878
57,76,209,214,180,193,929
16,19,66,74,46,42,263
7,6,3,5,6,9,36
27,48,108,104,98,109,494
24,41,98,112,102,106,483
57,72,184,189,165,180,847
56,69,194,197,171,198,885
54,73,187,186,172,186,858
47,74,184,186,166,164,821
46,68,178,191,171,167,821
21,20,53,62,42,46,244
52,72,215,222,174,184,919
55,69,180,198,167,171,840
57,78,208,213,175,185,916
52,73,204,210,179,185,903
51,79,199,196,154,167,846
54,73,197,212,170,169,875
55,75,192,203,164,172,861
17,22,50,59,40,42,230
50,68,194,202,163,189,866
43,61,170,172,141,159,746
51,68,165,170,150,164,768
46,83,197,191,168,187,872
46,65,168,172,154,158,763
11,19,41,50,34,39,194
51,74,195,206,172,160,858
16,22,56,60,41,44,239
53,76,198,213,165,169,874
56,78,208,202,172,174,890
51,69,200,204,173,183,880
51,71,188,199,187,184,880
9,17,40,45,36,29,176
55,78,202,211,181,166,893
13,20,46,55,41,32,207
16,26,56,55,46,46,245
11,15,48,56,44,39,213
14,19,49,52,37,42,213
15,20,48,56,47,47,233
37,50,131,128,118,126,590
58,81,199,199,176,182,895
34,48,122,150,135,126,615
48,61,165,176,139,170,759
50,67,189,210,179,170,865
51,75,196,211,173,180,886
55,72,205,210,167,178,887
50,78,198,206,176,173,881
49,67,202,220,173,191,902
28,35,115,119,83,89,469
10,14,38,45,39,23,169
58,70,187,199,151,157,822
59,69,187,212,179,176,882
48,70,190,200,177,172,857
47,70,173,178,159,165,792
44,69,167,166,158,172,776
46,78,191,209,177,161,862
11,16,40,47,41,33,188
12,16,42,43,38,31,182
52,72,191,202,176,181,874
14,20,40,43,35,35,187
39,56,151,157,129,135,667
13,19,42,55,40,42,211
13,20,45,53,39,48,218
46,69,203,209,173,184,884
29,34,114,110,81,83,451
57,77,187,182,157,147,807
51,72,188,193,158,153,815
47,60,176,182,160,172,797
49,69,178,191,169,159,815
45,61,171,192,156,174,799
45,63,172,188,161,168,797
31,45,106,110,107,114,513
36,49,127,130,106,114,562
43,53,161,173,159,160,749
40,62,169,179,150,149,749
13,15,45,56,38,32,199
16,25,71,79,74,83,348
15,25,79,76,59,81,335
16,22,52,52,42,34,218
9,20,56,48,40,39,212
50,65,181,186,164,156,802
47,61,183,175,146,144,756
49,59,165,150,133,142,698
11,15,36,28,24,22,136
12,21,64,54,32,29,212
10,18,56,58,47,41,230
18,24,76,74,58,53,303
23,34,84,92,73,74,380
5,9,18,25,19,22,98
26,40,99,108,92,92,457
44,59,161,147,132,133,676
1,1,0,4,6,2,14
47,61,165,164,150,160,747
2,2,3,5,4,2,18
30,43,124,139,118,108,562
0,2,2,1,1,0,6
0,26,37,37,25,0,125
0,36,53,58,42,0,189
35,53,135,135,121,133,612
40,61,162,172,158,162,755
31,40,108,118,97,104,498
21,29,83,110,99,115,457
47,67,189,170,144,173,790
28,36,91,92,62,58,367
27,39,97,103,102,95,463
39,53,156,164,136,137,685
50,66,196,199,180,187,878
11,20,49,53,39,36,208
23,28,71,63,46,47,278
27,39,90,92,86,101,435
44,62,176,174,154,156,766
45,59,175,169,151,151,750
36,46,111,113,112,127,545
41,49,137,147,141,143,658
50,70,179,182,174,179,834
48,72,173,187,175,172,827
41,62,159,150,140,134,686
45,66,160,168,144,139,722
42,43,128,132,112,125,582
31,44,116,122,110,112,535
44,61,166,183,161,169,784
48,68,179,182,163,160,800
51,66,181,190,162,167,817
34,56,151,151,126,155,673
41,52,153,155,144,146,691
50,64,180,177,162,172,805
42,69,168,186,162,182,809
47,67,190,182,173,173,832
52,72,183,187,170,177,841
46,60,152,164,141,149,712
39,51,137,149,126,131,633
44,53,152,156,138,155,698
35,56,156,163,137,133,680
28,38,109,126,99,109,509
45,55,151,149,136,154,690
0,44,71,75,40,0,230
0,40,72,75,41,0,228
0,35,66,79,40,0,220
42,59,180,191,160,173,805
0,39,64,74,41,0,218
0,41,60,71,36,0,208
51,65,190,204,169,179,858
50,64,189,189,155,168,815
11,30,66,67,56,33,263
15,36,73,93,83,59,359
50,69,176,179,167,174,815
26,41,114,114,104,103,502
60,82,191,195,186,189,903
37,49,129,139,123,138,615
13,22,58,64,54,54,265
5,33,66,70,46,28,248
17,27,67,63,46,49,269
14,23,72,79,47,53,288
0,35,57,75,48,0,215
18,23,64,75,54,51,285
16,27,65,56,49,51,264
36,59,149,153,136,136,669
14,18,48,60,40,29,209
10,14,42,47,41,36,190
50,68,177,176,172,158,801
36,52,140,143,116,117,604
18,22,59,58,39,44,240
32,30,89,89,74,85,399
7,9,20,18,16,11,81
33,48,143,150,118,116,608
19,31,75,78,61,68,332
50,65,174,185,157,165,796
44,72,177,166,146,148,753
28,43,98,107,103,96,475
42,64,168,166,150,147,737
28,34,95,101,79,82,419
48,68,190,198,161,169,834
22,31,78,77,78,64,350
40,62,164,161,141,145,713
43,61,162,169,143,163,741
45,59,169,152,137,161,723
41,52,157,155,143,145,693
30,39,107,116,96,111,499
45,61,167,152,131,139,695
21,40,97,107,88,101,454
26,44,117,105,95,100,487
29,41,106,113,98,111,498
41,59,158,166,151,150,725
54,72,198,198,171,176,869
46,73,193,183,167,167,829
43,59,161,165,140,148,716
47,74,204,190,163,177,855
46,67,185,187,166,172,823
44,71,181,191,163,174,824
47,71,194,196,170,165,843
44,62,163,174,167,171,781
46,69,173,174,157,155,774
39,52,136,146,127,129,629
41,59,165,173,147,133,718
49,74,193,191,163,166,836
54,71,179,179,163,172,818
0,40,74,76,46,0,236
9,30,94,90,52,31,306
40,56,153,152,142,149,692
28,55,149,151,130,137,650
28,55,149,151,130,137,650
18,24,54,59,48,42,245
47,61,175,189,167,163,802
31,35,104,103,89,84,446
43,54,137,146,121,121,622
0,46,75,75,47,0,243
50,69,190,194,173,165,841
45,62,169,151,139,145,711
52,70,202,194,169,183,870
58,81,220,225,169,175,928
48,69,193,198,161,161,830
53,76,189,209,170,191,888
51,74,187,186,153,182,833
17,29,77,91,71,65,350
15,24,66,63,55,66,289
19,33,78,68,66,78,342
48,65,175,173,151,158,770
31,41,126,118,97,96,509
21,23,72,78,67,69,330
18,25,65,68,68,59,303
28,28,77,73,63,61,330
50,80,191,179,162,185,847
43,65,174,190,158,177,807
47,69,173,182,154,163,788
33,41,98,94,90,97,453
51,68,168,161,141,143,732
48,64,179,174,149,171,785
57,72,183,191,169,166,838
34,56,151,151,126,155,673
39,52,147,136,100,116,590
26,38,120,127,104,109,524
43,57,167,156,132,154,709
42,63,170,170,150,153,748
48,73,179,181,163,161,805
17,23,56,63,58,43,260
17,23,54,53,52,52,251
41,56,125,128,130,137,617
44,61,159,171,142,145,722
55,75,185,189,151,161,816
37,57,152,161,143,146,696
36,46,156,141,129,135,643
43,55,148,158,136,153,693
38,59,156,163,138,145,699
39,59,168,160,133,134,693
17,24,63,74,52,48,278
39,55,153,140,123,125,635
42,52,135,135,115,109,588
24,16,54,64,67,55,280
42,57,157,155,138,154,703
0,6,12,8,7,4,37
52,73,170,178,160,165,798
17,21,52,51,43,34,218
36,43,131,132,118,142,602
39,47,141,136,116,129,608
37,47,140,140,117,127,608
32,56,155,156,139,149,687
32,56,155,156,139,149,687
17,34,77,84,70,73,355
40,56,146,163,149,138,692
37,53,136,143,129,135,633
36,59,156,165,142,137,695
31,46,110,130,125,112,554
33,49,142,138,104,109,575
25,37,92,85,80,88,407
48,60,166,173,146,153,746
44,58,158,167,139,157,723
18,22,46,53,38,39,216
16,17,59,59,51,58,260
24,33,82,81,67,72,359
31,27,89,77,71,67,362
48,68,190,201,168,165,840
47,58,167,192,170,172,806
51,61,167,190,159,156,784
41,63,162,157,129,132,684
11,13,44,50,28,27,173
47,66,181,180,157,164,795
43,57,173,173,151,169,766
29,35,102,114,99,100,479
37,45,116,126,107,116,547
52,66,185,199,170,173,845
23,30,74,70,62,70,329
32,38,94,89,64,65,382
32,33,95,96,77,70,403
8,8,4,4,5,8,37
42,63,159,167,145,150,726
36,41,106,113,102,95,493
36,47,123,122,111,110,549
32,43,114,113,105,108,515
7,6,3,8,6,3,33
8,6,13,12,9,7,55
33,54,134,133,128,126,608
2,4,2,4,4,3,19
43,62,177,200,164,147,793
40,66,177,170,146,159,758
13,18,45,51,43,39,209
8,7,3,6,7,9,40
3,5,5,5,8,7,33
0,0,2,3,1,3,9
23,38,101,106,74,88,430
47,63,164,143,117,152,686
17,31,87,86,70,74,365
18,25,68,63,42,68,284
24,40,107,100,79,83,433
50,73,191,178,155,145,792
41,59,143,155,129,127,654
55,72,204,224,167,176,898
25,27,70,81,81,69,353
10,24,61,77,65,68,305
19,27,67,76,62,74,325
10,14,42,47,41,36,190
29,36,99,99,84,81,428
14,18,54,64,52,40,242
32,49,117,111,91,84,484
4,4,2,5,5,11,31
27,31,76,69,64,71,338
4,5,4,5,4,2,24
21,35,105,101,83,90,435
26,29,103,98,80,90,426
25,31,88,89,79,83,395
25,26,66,70,67,54,308
28,41,95,100,99,109,472
41,55,139,152,132,135,654
3,3,2,5,9,10,32
16,22,62,63,49,52,264
4,6,11,11,13,22,67
35,58,143,141,119,121,617
51,61,183,168,160,175,798
42,62,160,145,123,144,676
46,70,177,173,151,168,785
30,34,93,87,82,92,418
53,72,203,206,167,174,875
56,75,191,193,162,165,842
53,71,192,212,175,180,883
48,70,198,208,169,174,867
10,29,62,63,42,37,243
14,24,62,63,53,57,273
58,77,193,202,174,191,895
39,55,153,157,142,146,692
