54,71,185,180,146,158,794
49,57,168,176,151,159,760
47,64,178,182,157,157,785
53,65,172,178,163,156,787
57,73,173,163,146,149,761
62,70,187,202,174,189,884
60,72,200,201,167,189,889
60,69,192,198,162,163,844
63,73,194,200,170,184,884
55,68,177,194,178,179,851
62,74,182,180,173,167,838
62,75,196,194,163,184,874
50,73,181,178,150,159,791
56,74,164,158,153,154,759
58,65,189,196,163,180,851
51,59,164,165,147,150,736
52,67,166,158,141,167,751
58,70,181,187,165,170,831
63,69,184,194,161,161,832
60,74,194,199,163,150,840
0,34,50,42,30,0,156
0,28,39,28,19,0,114
61,72,178,176,152,165,804
45,70,165,171,148,151,750
0,29,36,28,19,0,112
49,72,177,171,144,164,777
0,31,48,57,39,0,175
0,3,4,7,6,0,20
60,68,178,186,167,168,827
58,74,190,181,165,182,850
64,79,193,190,173,169,868
0,13,15,13,8,0,49
59,74,195,213,191,189,921
0,48,69,68,44,0,229
57,79,203,209,176,186,910
0,49,68,69,46,0,232
53,76,203,202,163,171,868
63,77,197,189,159,175,860
58,76,197,200,172,169,872
39,51,122,131,116,112,571
44,61,162,164,143,131,705
55,73,183,193,167,169,840
59,79,192,207,180,175,892
24,38,70,73,58,45,308
58,72,171,192,163,167,823
58,73,190,185,166,163,835
56,71,178,177,153,162,797
44,50,131,127,111,136,599
48,67,178,189,169,173,824
34,49,110,113,102,105,513
56,70,186,191,170,180,853
41,49,130,133,117,101,571
43,57,132,145,135,144,656
38,58,156,157,139,146,694
58,72,200,202,177,184,893
60,66,179,185,161,163,814
58,79,199,191,170,180,877
59,68,191,202,170,195,885
61,73,192,198,171,177,872
61,72,194,176,156,175,834
59,76,185,182,161,167,830
53,68,175,178,158,168,800
52,74,189,180,160,175,830
60,73,188,187,164,155,827
56,69,200,208,175,189,897
60,73,189,189,163,181,855
55,63,186,185,163,175,827
59,78,185,179,166,178,845
63,73,190,192,172,171,861
57,68,188,198,167,173,851
67,76,190,199,173,188,893
24,43,47,54,49,20,237
47,55,154,171,153,159,739
48,66,161,171,155,160,761
52,67,172,172,144,160,767
49,64,156,169,146,150,734
19,38,46,51,41,27,222
23,52,55,56,56,40,282
55,65,174,160,142,158,754
23,50,52,57,53,44,279
61,75,196,179,165,178,854
60,80,183,193,172,164,852
58,74,189,185,177,183,866
51,73,184,187,163,155,813
63,72,207,198,170,192,902
53,66,163,174,168,178,802
58,69,171,166,154,163,781
57,72,177,165,145,162,778
56,69,168,166,149,163,771
55,67,177,183,156,176,814
54,67,173,175,147,147,763
61,62,177,170,150,163,783
55,72,167,168,152,152,766
57,72,172,177,145,151,774
61,80,178,192,177,182,870
48,57,150,164,148,140,707
37,49,132,142,141,136,637
55,62,155,156,140,137,705
62,70,195,196,173,202,898
56,78,178,166,140,170,788
57,77,176,174,155,169,808
31,54,129,137,107,104,562
59,80,194,196,177,189,895
23,41,94,108,105,106,477
23,41,94,108,105,106,477
29,176,194,198,184,47,828
66,69,185,196,181,198,895
63,76,189,195,164,181,868
60,73,209,200,180,189,911
33,51,99,82,77,82,424
59,81,187,192,164,175,858
52,64,159,162,140,148,725
55,56,159,155,135,139,699
45,60,153,162,150,151,721
58,76,187,199,166,172,858
43,60,147,147,125,140,662
43,59,143,143,117,119,624
41,55,150,147,139,134,666
48,63,138,137,116,123,625
50,66,178,177,149,163,783
51,63,182,184,167,172,819
56,71,181,186,154,169,817
53,63,179,177,155,154,781
34,50,121,133,112,115,565
52,73,182,180,148,160,795
57,69,188,186,148,164,812
43,59,147,156,126,128,659
51,63,170,182,153,157,776
0,29,45,50,36,0,160
42,46,138,143,122,121,612
63,77,196,186,171,193,886
58,69,184,206,176,174,867
45,64,163,158,132,155,717
50,60,153,154,143,139,699
47,61,165,176,154,158,761
46,63,156,156,144,153,718
22,37,50,50,44,41,244
17,42,49,50,44,27,229
47,60,153,160,137,152,709
48,65,169,175,157,151,765
48,64,165,169,145,154,745
48,64,162,175,158,159,766
64,78,183,191,169,175,860
54,61,167,162,149,156,749
49,71,168,164,144,153,749
62,66,186,188,157,172,831
25,30,71,69,65,66,326
49,59,156,170,148,164,746
50,64,164,170,142,140,730
22,21,65,77,59,68,312
29,34,85,85,72,74,379
14,34,66,67,55,58,294
49,67,174,166,140,159,755
22,52,52,49,45,38,258
12,36,69,71,61,51,300
52,69,178,185,168,178,830
53,68,180,180,155,151,787
51,65,176,184,151,147,774
30,163,188,178,163,73,795
54,64,185,187,167,187,844
0,5,9,8,4,0,26
0,2,4,3,1,0,10
0,0,0,0,0,2,2
63,78,187,203,170,180,881
57,75,183,192,152,154,813
0,0,0,1,1,0,2
0,39,63,66,41,0,209
59,68,183,187,150,161,808
14,27,33,36,36,17,163
18,40,52,41,38,23,212
20,23,63,65,48,62,281
24,25,67,66,48,58,288
59,77,182,183,173,185,859
61,78,197,194,167,179,876
49,58,150,142,131,139,669
18,28,63,75,65,62,311
58,69,173,172,165,183,820
20,22,63,70,65,57,297
14,34,47,45,39,16,195
50,58,169,166,150,146,739
23,37,83,86,75,65,369
42,56,149,143,120,111,621
23,144,152,154,141,32,646
45,58,152,143,131,139,668
18,36,43,45,43,24,209
46,67,165,164,139,151,732
17,38,45,44,42,22,208
55,72,181,174,143,169,794
55,54,149,148,125,145,676
55,73,190,186,157,173,834
30,31,82,82,79,81,385
49,69,166,172,156,157,769
52,54,173,174,143,149,745
16,31,69,65,58,65,304
57,73,177,189,159,159,814
24,31,67,60,50,57,289
19,39,80,68,57,78,341
25,31,76,75,72,64,343
26,34,77,73,70,62,342
58,71,177,181,147,139,773
22,26,76,83,66,76,349
23,20,63,61,58,65,290
22,20,66,61,56,67,292
18,34,36,35,34,24,181
27,33,80,71,65,75,351
22,30,67,69,73,57,318
16,28,65,60,53,51,273
68,79,202,216,183,197,945
20,32,74,64,50,68,308
19,25,63,65,54,65,291
55,65,178,183,156,163,800
50,70,175,169,151,157,772
48,60,159,163,143,150,723
59,73,189,193,167,163,844
55,63,163,176,156,159,772
54,72,190,192,168,171,847
59,66,173,167,159,166,790
61,73,182,186,164,155,821
55,74,181,181,155,153,799
24,55,48,51,54,42,274
27,171,188,181,159,46,772
22,50,45,49,56,51,273
50,68,166,174,162,170,790
59,73,184,193,174,160,843
50,72,181,185,159,157,804
55,68,170,178,148,147,766
52,67,180,186,170,169,824
16,18,49,54,52,59,248
44,59,166,167,146,144,726
43,62,177,180,156,157,775
21,23,61,51,52,40,248
7,5,5,5,7,8,37
15,22,58,64,54,65,278
53,66,172,167,154,175,787
54,79,193,192,175,172,865
62,71,189,192,163,164,841
35,55,115,118,106,107,536
60,74,192,203,180,178,887
54,67,162,174,158,165,780
55,74,183,197,170,177,856
59,82,196,191,172,182,882
17,29,27,39,33,25,170
22,46,51,58,53,34,264
20,43,36,40,40,25,204
16,42,37,38,32,21,186
53,77,187,206,181,183,887
53,72,178,180,170,180,833
57,71,195,189,164,175,851
49,69,195,204,178,189,884
16,35,41,37,33,19,181
19,51,54,58,55,35,272
20,132,139,143,134,42,610
65,79,202,189,178,187,900
57,74,192,184,173,203,883
54,77,194,197,173,169,864
20,53,56,56,50,36,271
55,56,176,177,148,156,768
59,73,186,173,153,153,797
55,71,174,179,155,152,786
63,84,199,197,169,178,890
50,65,170,186,167,171,809
51,65,178,184,162,145,785
58,67,185,176,158,173,817
63,77,176,176,170,173,835
26,30,83,82,75,81,377
25,34,89,70,63,94,375
26,173,176,173,160,37,745
59,73,190,189,173,181,865
28,39,90,104,96,72,429
53,71,178,182,171,177,832
65,74,198,196,162,178,873
56,73,189,191,173,190,872
31,36,86,82,87,75,397
58,76,190,185,161,187,857
55,74,195,193,167,191,875
34,40,102,91,89,94,450
35,42,106,90,83,92,448
28,45,87,79,74,80,393
25,32,74,64,55,70,320
23,29,68,65,62,70,317
19,32,71,70,66,66,324
21,19,60,72,70,71,313
26,55,51,56,53,36,277
63,76,190,187,163,158,837
25,27,77,90,78,72,369
13,28,33,33,32,24,163
18,20,74,81,78,76,347
47,61,164,153,124,134,683
52,61,163,155,134,144,709
20,55,55,62,56,32,280
22,54,53,59,57,36,281
27,59,55,55,53,37,286
48,69,166,170,156,158,767
57,74,186,182,166,176,841
66,74,197,202,165,172,876
65,70,202,203,178,177,895
61,70,194,202,177,173,877
60,76,187,181,161,185,850
57,70,177,185,174,188,851
43,61,152,152,133,130,671
53,73,183,181,155,150,795
54,65,168,180,154,139,760
50,70,180,169,143,158,770
48,65,174,189,159,173,808
43,63,161,170,141,130,708
48,62,157,157,137,160,721
54,69,179,179,163,177,821
58,76,185,195,178,177,869
60,73,185,196,180,193,887
56,72,204,200,171,177,880
6,27,34,28,19,15,129
58,66,182,190,176,186,858
60,74,205,208,173,176,896
26,150,153,149,128,42,648
50,56,157,150,129,132,674
52,67,184,184,159,168,814
51,67,159,165,149,142,733
51,67,161,167,149,142,737
49,63,179,177,142,157,767
49,60,171,175,152,156,763
49,60,171,175,152,156,763
53,65,169,161,141,165,754
53,70,162,167,154,159,765
44,55,169,166,142,150,726
47,61,167,168,136,153,732
49,65,182,185,156,148,785
56,74,193,196,166,158,843
44,61,155,168,142,145,715
52,60,166,176,159,173,786
60,81,188,193,168,182,872
41,49,112,104,101,124,531
52,63,162,169,150,152,748
52,58,158,153,121,142,684
50,61,181,194,165,148,799
53,69,179,190,167,166,824
46,62,189,188,157,155,797
60,72,192,200,168,177,869
63,71,185,185,159,172,835
61,80,198,181,163,186,869
15,22,53,56,48,56,250
15,18,61,65,55,64,278
57,67,168,170,150,154,766
33,55,112,117,109,93,519
60,69,194,203,183,194,903
31,56,99,92,81,79,438
62,76,199,195,163,172,867
34,56,101,97,88,69,445
31,145,144,142,119,38,619
58,72,185,208,168,164,855
19,28,89,78,57,72,343
61,69,178,192,161,163,824
24,32,78,77,65,61,337
52,61,173,171,140,142,739
50,61,162,168,148,147,736
21,24,67,73,59,58,302
49,59,169,191,167,147,782
58,68,170,170,153,163,782
58,68,170,170,153,163,782
54,67,165,169,151,162,768
51,64,167,171,147,148,748
47,55,158,171,148,146,725
56,70,191,188,159,179,843
63,78,206,200,164,171,882
19,39,41,43,38,21,201
57,76,192,187,158,165,835
55,61,180,177,154,161,788
56,74,175,173,158,164,800
37,57,124,125,101,98,542
55,66,167,169,151,170,778
52,60,166,167,142,148,735
54,67,170,171,156,139,757
58,73,196,191,171,164,853
62,75,193,197,173,180,880
62,79,191,201,160,165,858
56,71,188,195,172,168,850
61,76,192,198,171,171,869
61,76,192,198,171,171,869
21,38,53,59,46,26,243
22,31,85,92,99,100,429
28,25,77,78,70,63,341
30,25,80,79,65,59,338
20,40,50,53,42,30,235
22,49,54,57,53,36,271
30,27,93,98,98,104,450
24,38,92,89,73,68,384
27,32,86,90,70,87,392
25,36,84,93,72,79,389
29,36,85,91,74,83,398
28,34,87,90,81,91,411
17,38,46,49,42,27,219
41,45,107,108,80,79,460
57,70,186,191,173,176,853
56,73,193,204,177,165,868
57,72,183,194,167,165,838
18,43,46,52,49,28,236
62,73,194,190,172,185,876
63,72,197,196,172,184,884
21,40,48,49,42,23,223
45,56,139,147,125,132,644
53,71,181,180,143,162,790
0,40,64,74,51,0,229
0,42,65,71,47,0,225
54,72,181,178,155,166,806
0,43,69,74,46,0,232
0,45,72,81,46,0,244
0,45,72,81,46,0,244
0,42,65,69,44,0,220
0,41,65,68,44,0,218
0,41,68,70,44,0,223
72,72,181,184,166,187,862
38,166,175,161,159,65,764
57,74,196,189,162,159,837
57,75,185,192,181,182,872
55,78,194,193,170,164,854
56,75,187,191,165,182,856
49,61,166,162,143,143,724
59,80,200,180,166,174,859
0,51,72,71,48,0,242
48,56,173,196,166,152,791
36,50,144,139,112,128,609
47,63,150,139,127,127,653
25,53,57,55,50,36,276
29,44,118,133,128,131,583
43,58,136,140,122,116,615
40,56,142,143,121,122,624
44,51,137,137,115,125,609
0,42,61,61,38,0,202
55,75,185,187,176,184,862
0,42,59,57,35,0,193
60,74,193,206,182,196,911
50,64,163,151,132,149,709
39,55,133,147,130,139,643
51,65,167,169,150,140,742
4,46,67,65,45,9,236
40,56,113,120,106,98,533
52,62,162,164,154,144,738
52,61,164,172,153,156,758
48,61,165,189,179,174,816
62,75,190,194,162,156,839
56,67,172,175,154,157,781
18,40,47,50,46,27,228
57,62,189,193,162,151,814
55,64,185,173,155,169,801
57,63,172,164,151,167,774
57,70,198,198,178,187,888
48,60,164,177,143,138,730
22,47,51,57,50,27,254
31,50,98,100,81,71,431
56,73,175,177,172,177,830
55,70,184,178,164,173,824
35,52,105,102,99,91,484
65,72,181,184,165,155,822
61,72,196,190,168,162,849
59,74,207,188,159,179,866
18,44,50,49,41,25,227
45,61,157,163,140,157,723
51,63,165,162,150,159,750
57,67,196,203,177,185,885
57,66,178,191,170,166,828
57,77,185,191,177,170,857
51,73,176,192,168,153,813
55,67,191,199,173,178,863
58,68,184,190,161,157,818
67,80,198,201,172,171,889
20,48,55,56,46,20,245
51,70,178,174,166,179,818
57,72,185,178,170,173,835
57,69,182,182,173,179,842
55,71,179,175,164,172,816
48,64,150,148,143,145,698
48,64,175,162,138,140,727
43,58,152,161,140,152,706
35,43,129,128,107,114,556
61,72,192,177,154,159,815
57,67,186,183,154,173,820
60,74,186,180,166,175,841
49,67,170,167,135,139,727
45,64,167,170,133,148,727
43,54,142,149,127,132,647
42,50,150,149,119,138,648
57,78,180,181,159,176,831
48,59,167,173,155,143,745
55,60,157,153,137,142,704
29,53,53,49,44,29,257
46,59,155,149,129,125,663
55,61,170,166,139,151,742
56,68,166,163,136,144,733
45,57,134,126,118,124,604
39,60,152,145,136,151,683
52,63,160,150,128,136,689
6,16,12,13,12,5,64
15,38,43,48,43,18,205
16,38,43,45,41,19,202
16,33,36,45,39,19,188
61,77,194,185,169,171,857
63,72,192,206,176,178,887
49,62,159,158,137,149,714
10,32,36,42,36,17,173
49,63,149,158,137,142,698
47,67,163,159,141,155,732
49,64,169,171,152,175,780
39,44,124,110,92,98,507
45,65,161,162,145,136,714
42,65,164,160,146,158,735
48,60,167,166,142,156,739
45,63,159,147,129,156,699
45,63,159,147,130,157,701
44,55,147,155,142,149,692
44,55,146,154,140,149,688
61,73,193,190,161,187,865
40,55,144,154,145,134,672
46,56,151,155,134,140,682
50,65,162,164,147,155,743
16,40,49,51,39,24,219
54,69,184,184,163,168,822
58,72,186,197,167,187,867
55,62,160,167,141,131,716
50,64,171,174,156,160,775
52,60,156,169,152,150,739
51,69,182,193,170,178,843
62,82,195,203,190,192,924
26,45,68,69,48,53,309
32,55,91,84,64,74,400
32,57,91,84,67,67,398
21,50,57,56,47,32,263
37,40,124,114,88,93,496
36,47,121,124,121,110,559
38,48,113,129,129,98,555
42,55,127,131,108,109,572
43,50,125,136,118,105,577
36,48,111,119,113,122,549
20,50,51,56,48,32,257
15,40,36,43,41,16,191
42,55,148,155,123,130,653
49,65,152,137,117,127,647
18,50,60,64,50,30,272
22,42,40,43,43,27,217
18,41,35,51,47,21,213
14,35,38,38,32,16,173
16,32,38,40,36,19,181
34,49,116,116,112,118,545
15,36,38,38,33,20,180
12,31,38,34,32,23,170
57,78,187,179,152,171,824
59,79,188,196,176,171,869
46,63,163,170,150,168,760
57,70,181,180,165,177,830
55,70,173,171,148,162,779
51,64,180,191,163,170,819
51,63,169,176,155,142,756
0,38,58,56,34,0,186
58,68,189,193,186,201,895
0,53,71,76,47,0,247
36,50,139,141,112,128,606
62,69,196,189,166,200,882
55,65,167,182,154,157,780
58,66,176,170,145,159,774
52,67,174,180,157,160,790
57,73,197,204,176,175,882
57,69,196,193,169,177,861
42,55,144,134,104,123,602
42,60,168,162,139,160,731
53,65,162,171,152,155,758
44,54,154,157,147,145,701
53,71,175,184,157,165,805
52,73,187,182,161,153,808
15,29,35,28,23,3,133
16,30,36,28,23,3,136
43,59,144,153,131,135,665
12,32,37,36,28,14,159
38,56,140,132,121,125,612
0,46,61,63,44,0,214
45,54,136,144,128,132,639
39,55,141,151,136,133,655
45,57,143,137,117,132,631
51,64,158,163,154,148,738
40,51,138,158,147,129,663
50,68,177,176,158,177,806
50,68,177,176,158,177,806
61,79,191,189,159,165,844
50,64,165,165,146,135,725
41,60,159,164,133,138,695
48,64,172,171,143,146,744
48,66,173,171,142,157,757
48,77,186,191,168,165,835
49,60,161,165,143,148,726
46,62,163,165,136,124,696
16,32,24,28,27,14,141
19,27,59,57,52,39,253
18,27,58,55,52,39,249
57,73,175,176,163,163,807
57,73,174,176,163,163,806
40,54,135,139,117,128,613
42,58,144,139,117,131,631
57,73,175,180,159,165,809
11,25,21,23,22,16,118
60,66,194,200,183,191,894
14,37,34,38,34,20,177
14,31,37,39,34,18,173
23,51,54,55,51,27,261
29,47,119,126,123,125,569
60,72,195,190,157,169,843
58,71,196,186,148,167,826
58,71,196,186,148,167,826
67,77,188,181,154,176,843
60,74,198,210,180,172,894
51,67,164,170,147,148,747
47,62,164,164,146,141,724
55,72,173,165,153,162,780
53,63,149,146,137,143,691
48,60,174,182,160,156,780
41,56,146,152,132,128,655
50,60,152,160,141,145,708
62,81,190,188,155,182,858
54,67,187,184,150,171,813
54,71,180,177,152,164,798
53,80,177,181,166,165,822
53,61,164,178,164,161,781
52,62,160,174,163,159,770
51,63,168,175,153,166,776
51,63,167,174,153,166,774
22,45,45,53,52,39,256
50,68,190,185,149,162,804
59,73,172,177,157,168,806
21,48,54,53,46,30,252
44,53,146,154,128,141,666
40,44,119,120,115,119,557
42,49,122,127,101,119,560
41,49,121,127,102,122,562
56,67,169,169,142,153,756
48,61,157,149,142,137,694
43,54,158,167,137,130,689
47,58,140,153,130,125,653
0,4,4,1,1,0,10
37,45,120,126,122,120,570
0,16,25,22,12,0,75
49,69,184,183,157,156,798
52,59,167,167,148,155,748
0,3,5,4,3,0,15
33,42,126,121,103,121,546
40,51,149,136,113,112,601
44,54,155,156,139,145,693
41,51,145,149,131,138,655
36,179,178,166,163,40,762
51,60,157,149,120,115,652
45,57,137,147,131,138,655
44,56,147,149,121,141,658
51,59,159,163,152,158,742
50,61,161,168,152,152,744
41,58,151,160,135,142,687
48,60,158,161,132,153,712
46,67,156,158,136,138,701
39,49,144,153,130,151,666
40,53,143,139,121,144,640
49,59,143,151,132,146,680
44,53,147,145,120,122,631
48,58,164,171,155,151,747
46,62,144,137,117,122,628
49,56,173,175,153,148,754
58,60,177,163,155,166,779
21,39,44,45,33,19,201
54,69,171,172,156,151,773
50,69,155,155,145,155,729
49,59,166,171,154,157,756
42,58,151,164,149,149,713
44,61,154,170,148,137,714
56,66,178,188,173,170,831
54,62,183,189,170,167,825
19,46,45,47,46,31,234
55,63,179,187,166,180,830
58,79,191,189,167,158,842
45,62,154,164,136,137,698
38,48,130,141,131,139,627
48,56,156,152,129,142,683
45,61,143,145,136,131,661
42,55,133,141,117,126,614
44,41,134,143,117,119,598
0,46,64,61,37,0,208
48,64,154,156,141,147,710
0,35,49,47,35,0,166
0,45,68,68,44,0,225
0,38,54,49,32,0,173
0,11,13,17,11,0,52
34,46,123,132,115,125,575
45,63,144,148,127,123,650
43,66,155,146,125,134,669
27,36,115,116,89,100,483
55,74,191,187,173,183,863
45,67,166,165,141,146,730
60,68,190,196,167,160,841
54,75,189,181,158,171,828
55,71,185,195,181,187,874
55,74,192,194,163,165,843
36,45,119,100,90,104,494
37,45,124,105,94,102,507
37,44,122,104,94,102,503
16,32,31,35,31,16,161
43,54,143,149,132,142,663
41,50,137,156,141,148,673
60,72,173,184,171,186,846
28,35,99,102,92,104,460
54,60,169,163,131,128,705
19,48,55,56,51,27,256
37,42,96,113,100,83,471
32,46,97,108,99,92,474
21,29,81,88,75,77,371
42,55,151,157,132,122,659
39,56,148,155,135,145,678
50,63,162,154,134,140,703
45,59,140,150,140,140,674
44,47,147,161,127,144,670
51,67,168,161,147,162,756
52,76,173,177,165,169,812
56,61,181,177,170,180,825
58,71,176,166,157,181,809
56,75,181,171,155,169,807
52,65,177,171,156,159,780
56,75,188,187,157,169,832
56,72,187,184,162,171,832
41,46,139,139,127,125,617
21,147,141,158,149,43,659
57,69,186,180,175,187,854
52,68,169,164,163,175,791
55,78,181,183,168,175,840
39,57,154,155,138,142,685
14,30,33,34,33,14,158
25,137,141,157,145,41,646
32,51,104,110,94,98,489
60,76,212,200,167,187,902
47,61,164,163,136,143,714
58,64,168,152,137,160,739
55,73,192,193,178,179,870
54,66,172,181,164,158,795
55,79,184,177,155,161,811
61,84,183,186,170,171,855
51,63,165,161,140,152,732
24,51,57,60,50,31,273
24,54,61,57,48,29,273
59,67,159,156,142,153,736
52,70,170,156,136,148,732
14,31,39,40,37,16,177
23,141,145,148,138,40,635
51,64,175,185,157,170,802
21,50,51,55,46,30,253
20,49,49,59,49,32,258
21,49,55,60,53,36,274
21,49,55,60,53,36,274
26,148,154,160,145,36,669
22,55,56,63,50,36,282
22,143,149,136,121,33,604
53,74,186,204,181,196,894
24,58,61,63,54,38,298
22,53,54,59,51,33,272
17,50,55,63,53,36,274
23,127,134,142,135,39,600
21,135,142,132,134,41,605
0,43,62,69,44,0,218
0,39,56,63,41,0,199
19,40,49,56,43,31,238
25,43,51,56,46,31,252
43,52,125,122,111,132,585
43,57,142,151,128,138,659
40,48,119,117,104,120,548
44,55,147,151,131,125,653
37,59,144,141,122,126,629
43,47,139,152,148,160,689
44,60,138,135,106,115,598
37,52,142,148,123,121,623
22,47,58,50,41,27,245
31,49,124,114,99,112,529
21,44,55,57,46,24,247
47,58,160,163,130,145,703
51,56,152,150,131,131,671
43,61,145,144,135,139,667
45,65,140,133,129,150,662
0,52,64,67,44,0,227
0,52,64,67,44,0,227
19,42,48,46,40,24,219
48,66,157,160,148,137,716
12,31,35,36,37,16,167
15,30,34,37,39,20,175
22,39,43,47,36,25,212
20,38,45,44,34,21,202
16,27,31,37,31,18,160
42,52,136,144,116,116,606
21,40,45,53,47,20,226
47,59,155,157,135,129,682
58,75,183,177,154,158,805
5,6,16,19,17,9,72
47,61,159,151,141,140,699
10,24,28,31,28,15,136
0,18,27,28,18,0,91
30,58,131,132,105,78,534
38,46,127,130,122,119,582
54,56,156,160,137,116,679
36,46,113,125,128,129,577
44,48,144,143,124,135,638
45,60,153,138,101,116,613
45,62,141,136,124,144,652
56,74,185,180,159,163,817
44,50,134,140,125,119,612
44,54,128,130,113,115,584
32,46,119,122,99,109,527
59,72,184,183,153,162,813
58,72,186,193,172,165,846
50,64,176,184,162,170,806
42,53,123,125,104,120,567
54,60,177,189,166,165,811
39,45,118,116,111,113,542
32,45,114,131,113,122,557
16,40,43,40,32,9,180
18,35,41,39,36,13,182
15,36,34,43,40,13,181
14,36,41,45,38,18,192
53,77,164,154,129,144,721
54,70,165,147,136,141,713
51,64,155,163,144,148,725
0,48,67,74,52,0,241
52,66,164,163,147,152,744
25,32,67,59,43,40,266
25,32,67,59,43,40,266
22,30,66,58,42,37,255
14,20,51,52,49,46,232
22,27,67,58,59,62,295
22,21,52,45,48,49,237
17,23,62,55,51,60,268
18,22,60,52,50,37,239
19,23,62,65,54,50,273
19,25,65,63,54,50,276
8,16,43,36,47,56,206
60,71,198,189,159,167,844
5,10,26,30,39,37,147
16,19,63,64,44,51,257
16,18,60,64,49,43,250
43,57,133,131,116,124,604
19,24,64,62,58,51,278
11,14,40,44,23,30,162
17,27,63,60,56,61,284
18,19,62,62,54,54,269
18,28,59,58,62,57,282
15,19,44,46,44,41,209
16,20,47,50,46,37,216
14,14,31,37,40,42,178
13,31,67,61,67,72,311
22,50,59,58,43,32,264
23,17,61,66,52,51,270
22,21,65,65,46,46,265
10,13,28,30,29,19,129
14,17,54,54,49,43,231
38,51,125,132,119,138,603
49,60,170,170,132,137,718
24,49,52,51,47,37,260
21,47,48,53,53,38,260
60,79,201,215,178,177,910
48,60,156,163,154,161,742
43,55,140,158,143,140,679
48,56,138,141,131,128,642
139,237,507,505,300,501,2189
2,1,8,12,10,7,40
15,43,51,51,51,34,245
53,63,164,155,139,134,708
51,63,166,159,134,142,715
56,69,176,176,147,167,791
51,71,175,181,164,184,826
49,64,170,180,158,158,779
17,44,41,39,35,18,194
18,40,47,43,35,19,202
39,43,119,115,118,134,568
36,44,115,125,108,85,513
40,54,126,133,131,123,607
51,70,193,194,171,174,853
44,56,146,144,131,138,659
47,57,144,139,121,116,624
31,47,120,116,95,81,490
42,47,119,139,134,127,608
57,70,179,181,152,149,788
1176,2325,4681,4709,2363,4679,19933
0,52,78,77,47,0,254
0,57,73,75,48,0,253
19,36,43,47,43,28,216
15,37,37,33,30,17,169
17,36,46,45,37,28,209
16,35,49,46,42,28,216
20,45,49,50,40,25,229
62,73,186,187,153,175,836
58,71,181,176,151,173,810
55,74,184,193,163,164,833
54,71,176,188,163,154,806
41,55,149,152,127,114,638
51,68,176,182,161,155,793
58,69,182,184,163,171,827
58,77,173,176,153,161,798
58,78,174,176,153,161,800
62,78,185,179,163,175,842
62,87,209,202,184,207,951
64,86,211,203,184,207,955
41,57,142,136,117,129,622
42,55,139,144,118,128,626
44,57,142,147,137,143,670
39,46,133,138,121,131,608
19,45,49,55,52,31,251
45,61,142,144,129,130,651
47,57,138,130,125,136,633
23,41,54,54,44,31,247
38,50,131,129,125,117,590
17,44,49,53,46,31,240
41,48,138,145,127,129,628
42,64,141,146,116,128,637
24,53,56,55,49,36,273
50,54,153,137,118,126,638
43,56,145,152,134,148,678
48,56,148,150,132,138,672
48,56,148,150,132,138,672
42,62,145,154,144,141,688
48,68,159,159,147,129,710
61,83,204,204,179,188,919
58,87,195,194,173,182,889
60,72,184,187,166,168,837
18,38,45,49,46,28,224
52,66,159,161,141,150,729
12,40,47,44,38,23,204
20,36,83,90,75,64,368
18,42,45,48,40,22,215
0,14,23,29,15,0,81
31,62,129,134,122,125,603
28,33,88,96,74,81,400
39,39,90,92,88,97,445
28,30,85,80,76,71,370
33,32,79,79,77,65,365
48,65,161,172,154,151,751
50,69,165,173,161,176,794
24,38,86,93,94,90,425
21,35,85,76,72,95,384
25,33,84,96,87,87,412
34,37,100,92,77,86,426
34,37,99,93,80,87,430
35,38,96,92,72,78,411
35,37,100,90,84,79,425
21,38,51,45,35,26,216
21,37,51,41,30,26,206
26,39,98,109,78,88,438
24,30,77,87,87,67,372
24,31,76,81,83,79,374
26,27,68,76,79,75,351
34,39,100,100,86,86,445
26,43,102,96,85,96,448
24,41,46,45,45,26,227
30,169,177,181,160,38,755
46,50,145,148,126,119,634
50,59,149,144,134,140,676
47,63,141,132,127,147,657
51,60,167,165,146,141,730
40,53,151,163,136,136,679
55,62,179,175,146,141,758
51,64,164,166,151,162,758
15,37,42,42,38,24,198
452,826,1671,1672,751,1601,6973
39,51,135,133,124,137,619
48,53,144,152,137,124,658
50,60,159,144,126,138,677
42,55,143,135,120,126,621
55,72,181,168,153,160,789
40,59,138,146,123,137,643
46,55,136,135,111,118,601
42,53,131,136,119,138,619
48,56,143,147,138,141,673
15,19,58,65,45,54,256
56,68,179,181,153,162,799
27,42,81,84,63,73,370
55,72,186,194,158,168,833
55,72,186,194,158,168,833
44,45,116,117,106,103,531
53,68,185,189,167,174,836
0,51,79,81,45,0,256
26,44,68,78,66,63,345
43,67,148,141,126,126,651
0,47,69,70,45,0,231
46,53,155,163,146,144,707
22,32,82,84,64,60,344
53,67,158,172,155,155,760
29,56,132,142,131,126,616
56,72,184,190,171,162,835
61,77,194,194,169,166,861
59,77,189,196,181,170,872
48,58,152,153,127,136,674
40,54,147,130,109,110,590
53,57,158,161,129,154,712
41,58,157,161,136,134,687
35,50,127,121,99,115,547
36,50,116,130,110,115,557
36,50,116,130,110,115,557
47,54,148,163,132,125,669
47,65,155,162,145,145,719
45,55,149,153,145,156,703
48,56,163,165,135,141,708
49,57,161,158,126,132,683
26,167,174,162,154,51,734
46,54,145,141,127,128,641
46,52,142,140,127,128,635
52,67,161,156,131,123,690
51,66,168,162,143,145,735
47,57,151,156,131,138,680
44,51,145,146,122,115,623
45,59,140,139,132,139,654
46,53,148,156,133,129,665
30,41,106,106,84,104,471
25,34,94,98,87,103,441
34,51,130,137,131,140,623
51,62,158,155,131,137,694
35,45,124,132,113,121,570
46,68,173,177,153,162,779
44,51,142,152,140,142,671
42,60,147,150,135,140,674
40,54,138,129,110,112,583
42,51,124,126,119,113,575
47,53,144,145,127,132,648
47,51,137,144,123,110,612
41,52,140,156,116,113,618
29,169,185,185,166,47,781
46,58,149,141,128,129,651
41,53,138,127,100,95,554
41,53,138,129,102,95,558
40,50,134,131,106,103,564
53,66,163,169,162,162,775
53,72,170,178,157,173,803
56,77,174,178,161,175,821
51,70,181,178,154,165,799
54,74,177,181,159,173,818
45,53,136,141,136,127,638
45,57,146,155,137,136,676
47,53,137,139,125,120,621
49,62,151,146,129,148,685
42,50,148,153,139,138,670
44,63,155,154,129,154,699
65,71,206,205,182,186,915
50,65,163,157,125,130,690
0,12,13,13,9,0,47
43,64,154,162,138,158,719
33,46,110,126,126,127,568
41,49,132,121,108,131,582
45,56,141,148,128,140,658
47,61,147,151,141,162,709
53,63,153,161,142,151,723
46,62,157,169,150,152,736
23,34,77,75,59,61,329
28,31,80,73,67,59,338
29,30,74,72,73,72,350
25,30,68,78,73,72,346
26,32,73,84,79,82,376
20,26,62,86,78,72,344
26,19,68,76,67,58,314
33,39,97,90,81,90,430
23,42,91,93,86,92,427
27,27,92,92,86,83,407
20,32,86,102,96,103,439
33,39,107,103,89,101,472
50,63,154,145,124,140,676
43,60,145,158,137,133,676
48,62,149,150,129,135,673
18,30,72,95,90,94,399
18,29,73,90,90,86,386
18,34,81,94,93,96,416
34,38,100,96,82,98,448
50,59,154,146,126,130,665
22,27,82,87,84,90,392
31,34,102,102,90,105,464
31,38,106,114,96,92,477
51,58,155,156,135,143,698
54,66,160,160,124,134,698
25,31,87,94,83,97,417
36,43,98,92,89,93,451
39,43,98,90,83,93,446
32,30,90,81,71,78,382
35,33,91,85,79,88,411
52,64,174,185,160,168,803
20,51,58,62,56,34,281
48,71,172,166,146,162,765
51,66,169,171,155,161,773
23,49,60,59,58,48,297
52,67,163,168,153,160,763
44,62,158,166,139,143,712
44,61,151,164,150,136,706
44,64,163,164,139,168,742
64,75,186,185,163,179,852
64,78,180,174,141,150,787
59,70,175,176,152,151,783
59,81,198,199,158,171,866
56,76,200,203,160,162,857
56,68,169,175,151,141,760
60,75,189,211,183,188,906
44,56,137,144,125,136,642
47,60,161,160,141,165,734
51,68,161,156,141,138,715
47,59,143,163,147,153,712
49,65,152,152,137,151,706
49,67,157,156,143,156,728
51,70,163,165,152,167,768
0,39,65,69,44,0,217
0,51,66,73,43,0,233
0,42,59,61,40,0,202
52,62,176,184,157,168,799
0,9,13,5,3,0,30
50,67,186,186,159,160,808
0,43,64,68,43,0,218
51,60,173,180,156,159,779
49,65,160,176,158,163,771
0,43,62,69,44,0,218
0,1,4,5,3,0,13
58,70,181,177,154,163,803
0,26,33,36,22,0,117
54,64,175,186,160,160,799
26,39,92,92,71,79,399
19,38,45,46,38,22,208
19,41,48,50,46,32,236
23,46,52,51,41,29,242
18,36,42,48,45,27,216
67,72,193,204,180,177,893
40,59,156,154,122,124,655
50,61,167,171,138,134,721
69,85,192,192,171,169,878
23,53,53,58,57,34,278
26,51,62,59,54,31,283
62,72,174,179,151,170,808
52,60,149,162,138,137,698
14,17,54,53,46,40,224
15,19,66,66,61,53,280
58,80,178,189,186,171,862
56,74,173,198,195,191,887
27,37,88,75,73,80,380
17,28,68,66,53,55,287
22,24,78,76,65,77,342
23,23,75,73,63,81,338
18,27,58,48,45,51,247
18,27,73,66,61,52,297
18,25,63,58,56,55,275
22,25,64,53,56,59,279
21,29,67,59,43,42,261
11,41,48,43,35,23,201
19,52,54,58,46,37,266
63,76,196,194,180,201,910
17,54,62,60,48,36,277
17,47,53,64,45,33,259
57,61,166,166,150,167,767
57,76,190,189,162,169,843
56,72,182,165,148,149,772
56,72,182,165,148,149,772
57,66,185,177,145,144,774
38,54,141,156,133,137,659
51,72,182,185,166,166,822
46,61,165,173,151,144,740
42,52,150,146,135,146,671
45,54,157,163,136,141,696
54,67,169,179,154,151,774
55,67,167,176,155,152,772
50,67,162,164,151,163,757
57,67,163,173,158,161,779
54,72,185,194,170,179,854
12,23,63,74,55,62,289
55,65,173,175,164,162,794
20,27,58,67,54,60,286
52,60,170,165,137,142,726
51,56,164,165,135,139,710
18,29,77,86,68,70,348
13,22,55,67,61,74,292
43,52,145,151,141,129,661
46,62,158,153,134,127,680
5,8,24,27,33,32,129
10,16,48,48,45,44,211
36,49,143,151,130,140,649
15,39,46,50,40,20,210
39,47,138,151,136,120,631
16,30,61,67,59,59,292
35,60,142,146,124,127,634
41,59,146,139,125,132,642
50,63,152,157,135,140,697
16,19,49,45,42,47,218
45,59,144,149,133,135,665
18,39,47,52,41,24,221
63,71,183,195,177,172,861
19,43,50,55,47,26,240
20,47,50,54,40,22,233
40,63,144,150,139,140,676
19,38,46,47,40,24,214
30,45,116,98,98,116,503
46,61,160,167,143,140,717
49,64,157,151,134,127,682
22,30,66,65,50,49,282
18,41,47,45,35,19,205
61,78,193,183,158,169,842
47,65,176,183,159,174,804
28,41,63,70,56,51,309
17,40,49,49,38,25,218
19,43,43,51,52,28,236
54,73,183,176,162,157,805
58,78,188,202,174,177,877
59,74,190,180,155,157,815
54,75,189,193,163,177,851
13,29,31,30,32,25,160
49,66,178,181,151,152,777
52,70,169,165,153,159,768
15,36,37,41,45,27,201
21,117,127,114,114,26,519
18,46,46,45,44,21,220
19,42,44,44,38,28,215
18,47,50,47,38,22,222
49,53,145,150,132,143,672
54,66,170,165,146,158,759
55,62,163,167,150,161,758
53,68,180,181,154,155,791
57,71,179,177,154,148,786
28,168,177,168,163,31,735
41,107,178,161,142,124,753
43,57,166,162,135,147,710
45,50,142,149,131,136,653
50,68,165,168,140,145,736
26,39,98,110,97,94,464
33,42,105,94,80,94,448
31,40,102,96,88,91,448
38,43,95,98,89,101,464
33,46,116,116,105,111,527
36,49,123,112,100,115,535
38,41,126,116,99,115,535
32,41,113,115,97,119,517
38,47,125,110,90,86,496
27,40,85,108,95,87,442
30,42,93,112,94,87,458
29,37,119,115,96,104,500
36,46,124,129,116,116,567
43,52,132,141,132,124,624
40,52,135,136,121,114,598
47,56,140,147,129,127,646
48,55,140,141,129,133,646
44,55,133,136,121,116,605
38,55,109,100,92,96,490
30,42,90,94,100,83,439
17,27,54,50,51,46,245
33,38,107,120,94,83,475
32,42,112,115,89,83,473
35,42,113,116,95,97,498
53,69,169,175,150,161,777
28,33,83,87,80,88,399
35,32,87,97,94,95,440
29,39,103,101,74,88,434
27,40,110,109,92,89,467
34,37,107,113,102,93,486
29,165,164,159,147,50,714
50,64,162,163,148,152,739
56,73,178,177,150,163,797
51,71,180,182,156,172,812
56,69,178,167,142,145,757
57,71,197,192,172,179,868
63,64,173,178,171,167,816
32,43,114,106,95,103,493
57,67,169,179,171,185,828
49,67,179,185,163,161,804
53,63,172,178,158,159,783
32,39,103,115,96,97,482
31,39,111,99,90,86,456
52,65,180,191,164,176,828
34,37,104,94,84,93,446
0,55,75,82,54,0,266
13,32,31,35,30,17,158
0,51,70,78,48,0,247
40,58,148,149,128,137,660
39,55,131,142,133,114,614
35,34,119,124,116,123,551
41,51,116,107,103,123,541
29,41,105,113,102,108,498
29,39,106,107,84,97,462
11,30,36,35,28,18,158
10,23,26,33,27,15,134
11,32,32,32,28,19,154
51,73,183,185,156,151,799
13,27,32,33,25,18,148
48,56,162,157,137,149,709
51,64,169,165,148,169,766
54,65,160,156,146,149,730
48,59,159,173,147,167,753
53,69,171,175,149,155,772
50,70,173,168,152,154,767
57,70,184,184,159,160,814
61,77,192,196,173,183,882
58,75,199,194,165,182,873
55,73,176,192,173,184,853
21,130,133,146,128,45,603
43,61,157,152,146,153,712
39,61,153,153,143,148,697
46,57,160,151,144,145,703
42,60,148,145,142,146,683
13,35,39,43,38,26,194
51,61,153,141,125,138,669
51,60,159,150,128,134,682
43,50,137,153,130,141,654
13,40,46,51,47,22,219
13,52,59,66,69,24,283
20,128,133,150,136,32,599
29,151,159,163,146,37,685
65,65,194,195,174,176,869
29,163,169,149,135,29,674
52,58,168,166,147,163,754
38,45,125,131,108,107,554
34,55,128,131,121,134,603
44,45,124,114,103,121,551
33,44,111,117,115,119,539
60,71,173,174,171,174,823
41,37,117,127,127,115,564
48,43,127,140,120,127,605
571,1031,2101,2080,928,2021,8732
421,758,1529,1519,654,1428,6309
37,74,175,180,169,162,797
39,43,108,111,95,108,504
62,65,184,178,166,165,820
39,51,111,108,103,95,507
44,43,116,116,104,106,529
34,46,106,110,108,98,502
30,32,81,83,83,100,409
33,47,118,125,121,126,570
34,45,114,124,117,121,555
43,46,116,108,94,111,518
42,47,129,133,109,123,583
41,51,127,134,106,112,571
45,47,128,124,100,106,550
55,72,173,178,170,160,808
13,31,34,33,33,14,158
33,48,128,131,111,115,566
33,48,118,117,100,96,512
32,34,111,120,104,107,508
31,50,118,122,117,118,556
38,44,118,119,111,104,534
48,64,171,177,154,161,775
43,53,136,145,142,115,634
0,54,73,78,49,0,254
1,42,58,76,47,1,225
10,42,81,87,57,19,296
17,30,28,32,32,17,156
32,35,95,107,94,111,474
30,41,114,119,106,101,511
25,39,88,106,99,111,468
30,35,86,114,113,117,495
28,37,85,113,112,116,491
39,41,115,103,82,76,456
31,35,97,99,95,110,467
29,43,100,103,94,115,484
30,48,111,108,80,65,442
21,31,86,97,83,79,397
26,33,83,90,77,76,385
25,27,77,87,80,67,363
32,42,104,97,82,100,457
12,25,23,23,23,13,119
28,154,166,159,138,44,689
43,53,141,154,138,141,670
48,58,160,169,149,167,751
49,61,160,157,144,140,711
56,75,189,193,167,184,864
41,44,124,123,110,101,543
41,46,132,130,113,99,561
56,71,175,174,148,123,747
37,38,104,104,87,89,459
18,26,56,51,57,72,280
15,26,57,69,59,46,272
53,69,189,177,160,164,812
62,72,183,193,166,164,840
52,70,189,182,167,182,842
35,43,110,104,83,95,470
28,35,100,101,91,105,460
35,42,95,108,95,90,465
24,34,86,83,72,75,374
25,33,81,84,75,85,383
16,20,62,57,49,49,253
0,45,66,73,50,0,234
37,50,135,117,103,106,548
39,37,118,116,98,98,506
35,43,120,134,122,116,570
26,39,101,96,83,93,438
36,35,105,106,86,79,447
44,44,130,121,100,111,550
33,44,138,120,95,109,539
36,53,133,135,114,126,597
30,38,97,90,72,79,406
20,37,95,97,79,88,416
22,25,68,69,60,65,309
19,29,69,75,72,69,333
21,22,65,71,66,73,318
31,34,85,83,72,69,374
33,40,103,104,84,86,450
45,57,149,146,130,120,647
43,60,149,146,138,131,667
41,55,151,155,135,141,678
53,58,149,139,117,123,639
42,57,134,129,118,123,603
43,53,139,140,127,125,627
22,39,94,93,82,89,419
0,56,79,75,48,0,258
27,141,139,142,125,36,610
0,12,22,23,12,0,69
23,34,93,93,82,89,414
9,59,73,71,54,20,286
32,31,97,101,87,85,433
30,36,90,96,82,83,417
14,29,58,55,50,61,267
29,30,92,97,82,99,429
24,31,92,94,85,99,425
24,38,82,85,81,81,391
20,38,76,83,75,86,378
0,54,74,83,58,0,269
12,56,78,76,54,19,295
0,52,70,85,59,0,266
25,32,95,103,85,78,418
25,32,95,103,85,78,418
29,32,102,103,89,77,432
45,49,136,144,118,136,628
53,71,176,167,141,149,757
33,38,97,84,81,99,432
39,46,127,128,113,109,562
33,33,90,95,86,104,441
39,56,137,132,115,135,614
39,57,132,122,101,108,559
15,24,54,56,45,46,240
15,24,54,57,42,43,235
7,9,36,42,38,51,183
9,8,9,16,18,12,72
19,23,57,53,55,65,272
43,45,127,141,115,119,590
43,46,129,142,115,119,594
37,55,122,125,118,127,584
0,36,50,52,35,0,173
0,1,2,3,2,0,8
0,2,3,5,4,0,14
0,28,39,41,29,0,137
0,15,24,26,19,0,84
0,5,7,10,8,0,30
60,73,202,195,176,176,882
56,74,190,191,176,172,859
31,37,83,84,72,56,363
60,77,197,195,167,165,861
45,58,147,143,132,143,668
43,55,146,139,124,125,632
0,47,74,81,49,0,251
0,45,68,75,44,0,232
39,48,119,128,112,134,580
39,51,136,142,130,130,628
39,51,137,143,130,130,630
42,59,142,146,140,157,686
39,51,136,137,119,135,617
42,52,140,143,136,154,667
44,53,144,143,133,158,675
56,74,202,197,162,178,869
55,75,201,203,174,175,883
61,80,203,199,180,179,902
55,72,185,182,169,174,837
59,67,188,186,168,177,845
23,144,137,147,126,30,607
0,46,69,71,43,0,229
0,39,64,78,53,0,234
43,55,151,138,109,122,618
19,141,134,142,134,42,612
52,58,142,145,133,143,673
35,50,140,147,126,126,624
55,71,188,196,172,173,855
66,77,189,186,170,185,873
66,77,189,186,170,185,873
65,69,183,187,171,180,855
58,81,185,192,175,181,872
60,76,186,184,161,159,826
59,64,181,188,159,153,804
59,70,189,199,173,180,870
58,74,185,180,172,176,845
51,64,187,201,173,172,848
53,73,183,187,172,181,849
56,72,190,195,174,175,862
57,68,174,181,158,170,808
45,63,154,166,142,135,705
41,57,151,149,124,139,661
46,62,154,157,136,152,707
47,60,138,145,135,135,660
50,67,158,157,136,135,703
47,66,161,160,134,133,701
51,60,141,146,132,144,674
43,59,157,163,141,145,708
49,64,152,161,132,135,693
48,66,160,163,141,152,730
49,67,179,168,141,156,760
51,66,163,163,153,145,741
46,60,160,150,128,145,689
48,67,150,140,129,144,678
51,60,150,152,129,138,680
54,63,166,160,139,132,714
60,68,173,167,154,170,792
12,35,40,39,31,19,176
14,35,30,35,27,24,165
11,37,41,51,46,22,208
37,58,132,126,112,120,585
41,52,131,126,116,116,582
40,50,121,117,112,109,549
41,50,119,123,117,110,560
42,47,119,121,114,113,556
38,55,118,121,121,124,577
40,42,119,133,110,109,553
38,46,122,127,107,108,548
46,55,150,143,137,149,680
0,43,61,68,46,0,218
54,64,171,176,157,151,773
52,68,173,192,165,147,797
31,43,110,116,102,98,500
2,2,3,3,2,1,13
47,66,142,138,117,122,632
45,53,152,159,137,133,679
41,46,129,125,109,119,569
43,44,136,142,127,129,621
22,51,54,53,50,28,258
45,44,119,106,90,102,506
40,60,149,132,106,113,600
36,56,127,115,94,109,537
27,46,116,126,108,105,528
35,49,118,134,119,108,563
33,50,114,135,128,133,593
19,36,81,75,61,59,331
24,27,67,57,53,59,287
37,44,112,106,91,90,480
17,42,46,49,39,20,213
33,35,96,95,86,94,439
34,38,104,113,106,99,494
39,42,113,108,104,113,519
47,40,105,92,106,102,492
39,42,108,103,104,106,502
38,38,101,100,103,102,482
38,37,113,104,98,114,504
41,43,113,110,104,98,509
43,45,118,116,111,103,536
43,45,119,115,111,106,539
30,33,100,91,73,83,410
37,50,130,136,104,103,560
33,39,100,87,83,88,430
41,47,120,113,91,80,492
39,43,106,100,95,94,477
39,33,95,90,91,100,448
33,40,104,97,93,99,466
26,39,78,78,73,68,362
0,0,3,5,5,5,18
4,4,8,15,20,17,68
5,10,9,8,9,5,46
5,6,4,1,2,5,23
4,3,7,4,3,4,25
7,6,8,6,5,3,35
0,2,4,5,3,4,18
3,1,2,2,2,4,14
12,19,28,33,26,15,133
4,5,4,4,2,3,22
5,7,9,8,8,11,48
59,82,207,202,172,187,909
24,48,90,103,87,73,425
63,76,194,210,187,180,910
43,52,133,140,127,138,633
63,68,188,188,166,187,860
30,41,87,84,69,90,401
65,78,196,192,173,194,898
62,76,190,187,166,176,857
3,7,11,9,14,21,65
28,155,158,153,150,47,691
2,2,2,2,0,0,8
2,4,9,14,14,10,53
2,2,3,5,2,3,17
30,170,175,184,175,44,778
5,46,73,74,51,12,261
34,56,127,122,93,88,520
39,56,123,115,95,92,520
62,72,200,200,176,176,886
59,81,204,204,186,180,914
39,65,157,163,134,132,690
60,74,190,197,178,181,880
61,76,204,210,168,181,900
62,78,186,197,176,184,883
6,5,7,9,6,10,43
31,29,81,81,82,91,395
21,35,77,85,81,88,387
35,43,108,113,108,97,504
4,50,76,90,58,7,285
49,66,183,194,168,161,821
52,71,176,177,159,162,797
52,71,176,176,159,162,796
57,69,180,189,163,158,816
56,71,187,186,153,164,817
8,26,35,34,31,22,156
35,46,98,103,95,98,475
19,29,60,75,72,64,319
50,59,145,150,144,129,677
16,41,44,41,38,23,203
0,43,68,68,44,0,223
53,74,184,182,159,157,809
53,66,193,194,164,168,838
58,72,184,185,161,169,829
55,72,194,201,159,156,837
56,64,188,185,158,163,814
25,57,55,56,57,43,293
53,52,156,167,145,144,717
62,78,200,206,179,178,903
13,31,28,33,30,17,152
11,31,27,15,17,9,110
48,67,158,146,128,137,684
54,70,193,199,163,178,857
14,36,32,32,29,20,163
2,3,3,3,2,1,14
54,69,171,175,153,171,793
1,1,0,4,5,3,14
52,65,180,170,148,167,782
3,6,14,15,10,11,59
54,66,191,177,144,158,790
45,64,162,162,148,160,741
4,5,3,2,0,3,17
54,59,172,179,150,162,776
29,54,119,113,96,91,502
57,72,193,186,167,175,850
49,67,166,170,139,138,729
52,65,177,166,146,163,769
4,4,3,8,9,10,38
43,56,139,139,137,146,660
45,59,143,140,138,148,673
58,65,188,196,162,155,824
14,36,39,43,41,14,187
55,65,184,194,171,175,844
15,35,36,33,41,28,188
52,61,168,171,148,150,750
48,53,128,121,114,114,578
8,8,13,14,8,6,57
15,27,34,40,35,19,170
3,4,7,5,2,4,25
4,4,8,6,4,7,33
57,63,187,186,158,169,820
5,6,2,7,8,5,33
39,57,129,135,115,123,598
3,5,5,6,6,6,31
22,31,80,85,75,70,363
6,5,9,4,4,9,37
7,6,6,8,5,4,36
7,8,11,8,3,6,43
6,9,5,4,5,14,43
5,2,6,5,3,9,30
27,44,94,91,82,87,425
54,73,192,201,175,165,860
62,78,207,202,173,184,906
56,75,192,197,169,172,861
15,25,32,38,36,20,166
46,55,130,130,123,130,614
49,70,154,170,156,149,748
47,58,152,155,132,134,678
4,3,2,4,3,3,19
25,26,76,72,66,66,331
25,27,78,73,67,66,336
2,2,1,2,2,3,12
34,34,89,81,65,61,364
49,67,167,159,145,161,748
11,30,27,32,32,19,151
40,37,112,99,78,85,451
36,44,104,94,77,74,429
64,80,203,198,171,177,893
4,2,3,4,4,5,22
3,1,3,3,3,7,20
3,3,2,1,0,3,12
28,38,96,107,94,91,454
45,54,134,130,124,150,637
51,64,154,150,134,133,686
25,33,86,108,97,88,437
38,49,113,124,111,110,545
40,49,110,119,112,120,550
49,59,150,152,134,123,667
29,37,93,114,107,94,474
45,52,121,128,116,114,576
47,52,117,124,123,117,580
40,38,106,107,95,95,481
38,39,99,105,94,91,466
42,46,125,124,101,101,539
33,44,102,103,91,92,465
61,72,185,193,179,188,878
40,46,115,112,89,101,503
57,72,186,189,172,187,863
34,37,106,109,100,98,484
60,79,197,192,171,177,876
46,55,132,146,134,133,646
42,48,135,136,128,141,630
32,44,111,105,92,109,493
34,39,114,109,87,99,482
30,34,95,98,86,95,438
31,39,102,102,93,85,452
51,75,182,193,167,160,828
53,74,188,190,165,165,835
31,41,115,115,102,97,501
55,73,188,187,159,178,840
63,79,185,179,154,176,836
33,36,109,117,99,99,493
33,37,110,117,97,100,494
39,47,107,104,88,93,478
22,49,56,55,57,38,277
14,41,42,43,41,24,205
21,36,98,101,84,64,404
26,33,82,84,79,82,386
31,42,104,102,82,86,447
23,35,71,69,73,85,356
14,16,33,32,31,32,158
16,41,44,49,39,24,213
19,24,47,50,49,44,233
7,6,13,10,9,5,50
21,50,54,63,56,35,279
17,37,40,35,32,17,178
15,35,35,33,33,18,169
8,25,32,27,24,12,128
0,0,0,1,2,3,6
13,31,30,39,35,17,165
19,25,79,66,47,53,289
0,1,5,6,4,1,17
24,44,50,56,53,32,259
41,40,102,99,85,98,465
33,45,119,120,88,92,497
34,35,105,103,93,103,473
35,44,103,111,95,99,487
65,74,192,203,176,175,885
4,3,5,6,5,8,31
5,4,7,9,5,4,34
5,46,71,79,51,11,263
58,61,187,179,143,158,786
0,43,64,69,47,0,223
56,66,183,182,146,153,786
52,75,192,196,171,178,864
0,43,68,71,42,0,224
13,28,27,28,31,19,146
0,50,75,78,49,0,252
0,56,76,76,49,0,257
60,80,197,198,180,175,890
55,65,172,175,161,162,790
53,72,184,185,163,196,853
54,72,184,181,158,192,841
59,84,202,198,181,168,892
57,78,196,201,194,198,924
61,72,209,202,175,177,896
30,43,101,94,90,86,444
7,3,6,5,5,10,36
40,51,128,131,118,125,593
42,60,132,137,129,128,628
8,3,10,9,8,6,44
60,81,204,202,165,163,875
56,67,202,207,170,181,883
49,69,188,190,166,178,840
58,73,182,188,176,175,852
56,77,181,179,158,161,812
58,73,177,176,159,162,805
3,3,0,0,0,2,8
63,74,176,191,182,188,874
0,0,2,4,4,3,13
46,56,148,143,119,120,632
36,39,108,102,92,89,466
0,46,66,64,44,0,220
42,43,126,122,109,118,560
50,57,152,172,146,142,719
9,20,23,26,23,6,107
42,58,139,138,116,131,624
57,80,208,209,186,189,929
10,13,16,12,12,20,83
49,67,171,185,159,161,792
54,68,172,181,150,161,786
30,31,83,80,59,61,344
7,6,3,3,2,0,21
57,79,193,186,170,190,875
41,52,123,120,104,111,551
46,53,141,148,130,133,651
46,53,141,148,130,133,651
64,75,184,191,179,198,891
11,11,23,14,16,24,99
37,38,98,107,104,105,489
37,38,98,106,102,104,485
37,51,133,143,130,120,614
14,31,64,74,67,63,313
15,29,69,79,84,81,357
30,42,105,94,85,102,458
32,42,113,109,94,101,491
12,18,19,16,16,11,92
36,46,114,103,89,92,480
34,40,108,109,99,101,491
36,47,113,113,99,103,511
21,28,57,69,60,44,279
5,16,21,22,18,11,93
25,58,57,57,52,37,286
17,37,36,35,28,11,164
10,23,27,29,21,15,125
59,75,189,193,167,189,872
14,28,39,42,45,37,205
17,35,39,40,35,16,182
15,34,37,35,38,22,181
18,41,46,44,41,17,207
61,73,183,199,175,168,859
52,67,186,192,165,173,835
56,74,195,196,178,180,879
19,36,44,35,34,17,185
50,69,185,190,162,167,823
53,68,175,173,145,157,771
10,27,29,28,24,17,135
19,32,73,85,85,84,378
14,11,41,40,33,45,184
30,37,86,70,63,76,362
24,25,81,96,78,88,392
18,25,61,75,64,57,300
26,30,83,86,77,85,387
26,28,75,85,72,71,357
19,22,70,76,61,51,299
15,15,48,48,42,47,215
54,67,165,171,147,149,753
17,20,63,63,50,62,275
43,50,136,139,113,137,618
36,51,135,136,120,117,595
23,27,77,83,71,70,351
28,33,75,66,59,76,337
62,74,202,199,176,186,899
62,77,203,207,169,160,878
0,51,74,75,50,0,250
20,25,57,62,59,61,284
51,63,166,172,153,151,756
22,25,66,57,54,55,279
14,15,47,38,29,35,178
61,77,192,190,167,173,860
56,70,181,194,166,164,831
21,24,60,65,63,61,294
39,110,149,133,115,83,629
12,26,32,32,28,16,146
18,21,58,57,43,44,241
0,42,64,70,40,0,216
13,32,33,27,28,15,148
28,27,92,97,78,82,404
10,15,41,36,28,48,178
24,38,76,79,77,99,393
19,26,64,63,56,41,269
8,26,28,21,18,8,109
60,73,188,184,167,177,849
59,74,186,182,169,180,850
28,45,102,107,81,88,451
32,46,103,104,84,92,461
26,41,99,105,85,97,453
11,20,26,24,18,10,109
0,46,68,67,43,0,224
31,46,99,97,85,97,455
53,76,187,190,168,170,844
9,28,25,31,28,14,135
26,32,83,91,78,81,391
31,33,97,84,67,69,381
26,32,85,79,65,62,349
22,27,70,84,77,72,352
24,59,61,54,49,35,282
28,35,80,90,92,93,418
22,52,60,64,57,38,293
18,29,73,79,69,60,328
21,33,78,81,70,56,339
24,32,75,86,77,76,370
34,32,94,96,86,78,420
30,29,95,102,79,70,405
0,51,73,72,45,0,241
25,30,83,75,57,69,339
24,30,84,80,62,78,358
23,31,77,67,50,65,313
20,50,51,51,48,35,255
0,46,67,77,48,0,238
12,17,42,40,28,26,165
13,20,43,42,30,26,174
25,32,83,86,73,71,370
24,31,82,85,70,66,358
13,20,43,42,30,26,174
46,57,161,158,134,130,686
4,8,8,16,22,16,74
21,24,70,76,65,67,323
25,26,70,71,64,73,329
61,74,196,198,161,171,861
59,72,197,194,168,166,856
56,72,185,194,184,172,863
22,27,68,73,65,63,318
21,27,67,58,58,50,281
44,60,144,164,152,144,708
25,38,94,97,79,79,412
25,46,86,84,67,77,385
26,42,103,105,84,92,452
27,40,91,97,75,67,397
25,32,83,93,82,79,394
18,35,47,57,55,33,245
26,32,82,89,75,88,392
23,31,75,85,71,84,369
33,34,88,89,89,95,428
27,32,90,86,83,84,402
2,4,3,3,2,2,16
25,29,76,70,61,79,340
2,1,3,5,3,0,14
14,29,32,26,28,20,149
52,66,179,189,169,166,821
26,27,83,90,75,71,372
27,30,94,95,75,78,399
26,31,92,95,76,81,401
27,30,85,97,85,77,401
33,45,105,111,87,92,473
28,33,89,96,83,68,397
0,50,71,82,50,0,253
23,32,75,95,84,47,356
13,21,26,20,17,11,108
7,6,6,3,5,8,35
0,49,73,74,45,0,241
0,45,66,73,47,0,231
20,35,84,84,68,78,369
10,19,18,28,22,9,106
63,77,200,201,178,181,900
0,46,66,76,46,0,234
11,17,18,21,10,7,84
36,50,143,135,107,102,573
13,31,36,40,32,14,166
18,24,65,67,51,57,282
56,76,179,163,154,167,795
53,71,183,185,159,165,816
23,140,144,147,122,32,608
46,63,147,148,139,142,685
49,65,161,164,147,164,750
60,73,179,176,163,166,817
63,72,188,188,165,165,841
58,77,192,192,167,164,850
58,73,191,190,163,180,855
39,55,145,132,108,107,586
8,21,23,23,21,14,110
61,76,194,187,163,179,860
9,18,26,29,23,12,117
63,78,183,189,170,195,878
1,1,2,4,5,1,14
15,28,29,36,32,17,157
54,75,185,212,189,197,912
61,75,199,213,184,189,921
59,72,193,194,166,188,872
66,79,178,190,178,222,913
53,64,185,200,173,178,853
9,27,32,29,23,15,135
65,79,193,197,174,192,900
53,70,175,190,174,177,839
40,44,118,124,108,126,560
44,45,120,119,106,121,555
32,45,112,118,96,103,506
39,48,120,123,103,103,536
9,19,26,29,25,9,117
9,17,24,30,26,9,115
26,35,92,108,115,113,489
30,36,93,85,91,94,429
11,20,24,30,26,7,118
24,36,103,102,90,101,456
64,83,205,202,179,203,936
12,21,23,32,28,12,128
40,41,122,114,98,84,499
9,24,27,33,29,14,136
10,23,28,28,24,12,125
11,24,24,30,26,10,125
11,24,24,31,27,11,128
51,63,174,177,146,151,762
58,64,167,164,151,153,757
48,64,177,175,150,148,762
52,77,200,188,163,174,854
22,50,47,54,49,32,254
19,44,47,59,55,24,248
12,29,34,34,29,12,150
2,4,6,6,6,5,29
42,62,155,142,112,109,622
1,1,2,0,0,4,8
5,5,3,2,3,2,20
2,1,3,5,3,4,18
13,23,23,27,26,22,134
16,22,50,51,48,66,253
2,1,5,7,6,10,31
0,0,1,1,1,3,6
54,74,178,183,161,164,814
52,65,172,177,155,153,774
23,22,69,71,67,75,327
3,4,4,3,2,4,20
33,128,155,159,156,116,747
45,65,177,171,148,142,748
59,70,193,193,173,196,884
28,40,73,67,77,74,359
0,32,44,48,30,0,154
56,67,185,189,165,185,847
64,79,197,180,171,186,877
51,70,157,159,150,166,753
48,58,149,171,151,149,726
9,26,28,26,24,19,132
10,27,28,23,24,15,127
611,1143,2344,2363,1154,2339,9954
365,667,1381,1385,712,1367,5877
35,50,123,126,96,107,537
19,49,48,55,46,31,248
19,48,49,55,51,32,254
63,77,184,196,177,184,881
60,70,172,175,160,170,807
60,74,179,180,168,184,845
0,41,64,60,35,0,200
0,52,77,73,45,0,247
6,18,21,24,22,13,104
8,28,21,12,16,12,97
25,157,164,176,156,38,716
7,17,20,17,14,11,86
16,39,32,39,37,12,175
60,74,190,197,178,184,883
25,157,153,173,150,43,701
26,159,153,171,148,39,696
38,43,120,128,104,96,529
33,30,91,82,66,77,379
46,55,142,148,111,100,602
19,26,63,61,59,68,296
35,43,139,149,124,125,615
30,34,107,116,89,79,455
45,55,164,164,136,153,717
45,59,156,150,130,137,677
6,24,23,25,22,13,113
18,34,101,112,79,80,424
24,156,154,161,147,37,679
29,35,83,77,73,79,376
7,15,13,22,18,12,87
2,3,1,4,4,3,17
24,163,167,167,158,42,721
27,35,79,74,71,81,367
23,152,151,153,142,44,665
8,8,7,10,6,10,49
32,41,97,108,103,111,492
37,41,107,121,111,91,508
4,5,6,7,5,3,30
0,50,72,77,49,0,248
0,46,69,75,45,0,235
0,46,67,76,49,0,238
0,46,65,71,44,0,226
55,69,177,185,164,178,828
36,51,87,88,71,66,399
0,39,62,57,37,0,195
0,0,3,6,4,1,14
60,76,193,195,169,187,880
57,75,186,189,158,174,839
32,58,126,131,116,106,569
35,61,145,148,125,123,637
55,72,175,188,172,194,856
55,75,179,184,171,188,852
49,67,173,180,166,174,809
58,78,182,197,173,177,865
18,87,105,111,95,41,457
3,2,4,5,2,5,21
57,70,179,186,168,186,846
57,70,179,186,168,186,846
4,3,6,6,1,0,20
4,4,2,3,5,7,25
30,34,83,74,67,71,359
28,45,90,88,87,71,409
31,43,110,107,94,87,472
28,35,79,96,94,78,410
0,18,26,33,22,0,99
32,41,100,98,89,95,455
26,28,80,83,74,98,389
29,34,89,85,72,91,400
36,40,96,92,87,83,434
32,38,94,103,91,88,446
32,32,89,93,92,89,427
27,38,91,90,74,96,416
31,32,91,95,76,91,416
30,34,92,99,86,88,429
30,40,94,100,86,85,435
30,35,92,85,71,64,377
27,39,94,85,73,74,392
29,38,97,99,87,80,430
41,57,141,132,112,125,608
24,38,96,91,82,81,412
31,39,107,105,90,88,460
32,41,116,107,91,83,470
27,40,82,79,81,78,387
30,39,110,111,85,81,456
25,41,92,99,88,76,421
29,43,106,109,87,77,451
32,37,99,97,83,94,442
30,44,79,92,79,81,405
33,44,107,98,93,100,475
29,38,95,86,82,95,425
40,39,117,107,87,89,479
35,34,113,107,99,96,484
31,38,103,97,85,79,433
31,35,102,97,83,81,429
33,37,108,106,87,79,450
39,44,114,110,100,89,496
30,45,105,109,100,97,486
38,43,104,107,96,92,480
34,42,95,92,101,119,483
30,45,99,109,104,113,500
38,47,138,135,106,112,576
23,29,80,93,88,103,416
47,52,131,129,117,132,608
25,28,86,85,75,82,381
25,32,82,84,77,92,392
24,31,81,85,75,86,382
48,50,132,123,117,122,592
38,50,125,132,117,111,573
35,39,109,115,99,99,496
31,35,104,111,96,90,467
35,43,104,105,97,97,481
30,31,84,85,86,85,401
30,33,72,70,62,73,340
27,36,85,88,77,75,388
5,10,12,15,10,7,59
4,5,7,13,14,6,49
7,11,9,7,6,5,45
6,18,22,11,11,8,76
7,7,8,14,11,4,51
3,4,5,11,9,3,35
26,33,92,105,74,72,402
12,11,30,43,43,41,180
11,12,51,63,57,63,257
34,37,99,104,88,84,446
37,39,109,113,93,94,485
3,5,14,14,8,8,52
30,40,113,119,89,90,481
17,33,35,33,29,16,163
12,30,35,33,29,17,156
5,10,12,11,8,2,48
5,5,5,5,4,3,27
12,19,26,35,36,26,154
36,46,114,114,99,108,517
27,38,95,98,91,95,444
5,16,17,15,12,13,78
14,42,87,84,58,42,327
0,52,76,77,44,0,249
11,32,33,26,24,17,143
13,33,36,33,34,26,175
49,55,146,142,129,142,663
42,44,129,139,127,123,604
11,15,33,28,27,33,147
10,11,18,15,16,21,91
16,45,50,47,40,24,222
19,23,81,89,86,95,393
21,35,89,86,87,86,404
22,30,71,77,67,83,350
24,40,88,86,70,92,400
27,33,103,111,90,85,449
60,82,195,193,174,179,883
64,73,191,188,171,177,864
55,79,194,191,169,169,857
64,72,187,183,168,169,843
64,74,204,207,172,184,905
58,71,190,191,174,188,872
54,70,180,190,178,172,844
0,46,67,73,42,0,228
33,35,93,90,76,73,400
0,54,77,72,42,0,245
0,42,61,67,42,0,212
49,57,165,160,138,132,701
22,31,82,95,67,74,371
57,73,188,196,176,190,880
62,78,189,191,168,171,859
0,1,2,2,1,0,6
0,1,2,3,1,0,7
3,1,7,11,10,6,38
43,55,157,166,136,144,701
37,57,150,153,135,119,651
42,50,134,133,116,118,593
14,21,20,19,23,19,116
41,48,131,136,121,115,592
34,45,127,134,112,106,558
21,34,94,91,91,102,433
14,37,35,39,36,19,180
14,20,58,65,51,66,274
14,21,61,63,60,61,280
38,40,112,109,87,87,473
15,30,33,35,26,15,154
13,24,25,33,26,16,137
19,30,70,85,78,73,355
21,29,71,73,68,77,339
0,49,65,64,43,0,221
13,18,32,39,35,23,160
27,37,107,92,80,94,437
30,36,96,85,73,78,398
0,55,74,73,45,0,247
0,53,76,91,67,0,287
22,32,75,79,65,77,350
25,33,68,66,69,80,341
63,75,197,213,189,184,921
17,43,45,45,38,23,211
32,54,134,142,126,118,606
30,37,91,83,84,100,425
24,36,59,55,48,41,263
10,22,22,24,21,16,115
10,23,23,25,22,7,110
58,74,197,205,169,166,869
59,75,193,192,162,164,845
10,22,23,32,30,12,129
8,22,23,34,30,8,125
10,13,34,32,21,29,139
32,163,170,172,141,37,715
9,20,19,22,19,16,105
12,20,24,20,16,17,109
50,73,189,191,168,186,857
55,68,201,199,167,168,858
48,67,155,153,132,144,699
25,39,86,82,78,90,400
36,41,103,100,90,99,469
49,67,172,165,146,150,749
58,68,205,218,182,191,922
31,41,102,105,90,96,465
32,38,95,93,84,100,442
29,43,99,86,73,103,433
41,50,120,99,90,82,482
29,37,106,101,99,115,487
30,37,106,119,100,101,493
33,45,117,108,99,101,503
29,37,92,101,89,101,449
30,37,92,99,89,102,449
39,45,119,114,104,90,511
36,43,108,98,87,99,471
21,35,83,81,74,76,370
20,29,77,78,69,73,346
61,81,190,192,169,169,862
60,74,195,204,177,189,899
45,55,144,136,114,127,621
32,43,106,108,97,103,489
35,30,101,112,101,109,488
28,31,75,73,64,79,350
31,35,115,127,99,96,503
1,0,1,0,1,1,4
47,51,134,129,124,129,614
9,23,27,28,30,19,136
2,3,2,4,3,0,14
2,3,2,3,2,0,12
60,73,181,180,177,169,840
9,26,29,27,25,14,130
52,68,187,195,172,193,867
58,75,184,187,167,184,855
56,79,196,188,168,177,864
33,37,92,94,80,85,421
13,29,31,25,24,14,136
0,46,68,74,49,0,237
0,49,70,76,47,0,242
0,48,75,74,44,0,241
0,54,75,68,43,0,240
0,45,68,71,47,0,231
53,76,185,186,172,176,848
19,36,60,70,70,42,297
19,31,71,66,54,53,294
18,19,55,51,52,73,268
5,7,7,2,2,1,24
3,4,3,1,5,4,20
55,72,190,188,161,181,847
61,73,194,184,167,175,854
28,159,165,162,149,50,713
37,50,142,144,123,131,627
63,73,200,190,158,171,855
43,54,142,150,135,145,669
42,47,126,127,112,123,577
23,30,77,72,52,47,301
19,30,66,71,47,44,277
37,56,122,123,109,104,551
49,63,148,147,118,138,663
51,63,149,152,124,146,685
51,62,146,154,126,146,685
12,33,36,31,30,13,155
48,63,166,179,156,161,773
56,72,184,191,169,186,858
60,76,189,201,184,194,904
62,70,161,171,155,153,772
14,31,31,34,34,13,157
19,36,37,30,32,16,170
12,27,29,32,26,9,135
1,1,1,6,5,4,18
57,76,188,180,162,174,837
12,8,19,21,25,22,107
13,25,28,24,19,12,121
63,75,207,202,168,182,897
58,71,178,176,161,192,836
15,42,43,46,41,23,210
48,59,147,150,148,152,704
28,34,87,92,90,95,426
59,71,185,198,182,178,873
57,67,181,196,175,174,850
61,65,175,184,171,162,818
61,80,180,191,169,164,845
44,61,156,173,145,141,720
35,46,114,116,110,120,541
35,48,110,113,107,107,520
4,12,14,13,11,11,65
18,26,53,44,32,40,213
5,14,14,18,20,9,80
6,4,4,5,4,2,25
1,4,5,6,3,4,23
4,18,18,24,22,8,94
29,35,93,90,58,54,359
24,34,88,89,78,87,400
3,4,1,1,5,10,24
6,13,10,8,9,6,52
2,4,7,5,1,2,21
2,9,6,9,8,7,41
9,25,26,28,28,20,136
3,12,14,8,6,4,47
14,15,30,30,27,27,143
7,5,5,3,1,10,31
2,3,4,4,4,11,28
35,52,120,123,105,117,552
38,43,107,114,105,111,518
53,68,178,174,148,170,791
33,53,120,122,109,116,553
20,46,95,92,74,57,384
21,46,88,88,77,60,380
49,63,165,172,148,156,753
0,50,65,69,43,0,227
44,65,153,150,119,116,647
55,63,167,181,153,161,780
6,14,13,20,15,8,76
60,77,202,200,176,178,893
13,30,32,31,29,18,153
8,17,14,19,14,11,83
8,22,20,26,22,12,110
56,71,191,205,184,194,901
9,20,25,20,17,10,101
11,25,30,26,27,11,130
9,22,27,26,23,10,117
57,65,180,180,155,164,801
0,59,70,70,45,0,244
0,54,66,70,42,0,232
0,52,72,81,50,0,255
13,28,31,29,33,19,153
18,38,36,38,38,21,189
0,44,64,76,44,0,228
40,52,133,119,113,117,574
18,39,36,31,31,25,180
5,5,7,7,2,6,32
10,29,27,25,30,20,141
50,52,126,136,122,115,601
45,58,135,138,126,141,643
66,76,190,191,173,188,884
57,77,190,184,165,197,870
54,64,174,177,164,162,795
60,68,171,176,170,180,825
21,23,66,58,45,52,265
48,62,163,173,144,164,754
43,56,149,165,135,123,671
47,55,164,173,136,126,701
57,73,187,185,166,171,839
56,68,186,188,169,181,848
58,73,195,198,168,170,862
8,19,16,16,10,7,76
4,3,8,11,9,4,39
4,3,8,11,9,4,39
38,47,116,107,104,98,510
29,42,93,104,94,98,460
42,58,146,153,128,127,654
39,50,131,131,125,121,597
39,47,134,131,107,110,568
30,41,113,118,103,110,515
57,75,194,196,176,173,871
56,71,169,179,165,175,815
21,21,60,58,52,56,268
24,24,79,83,65,50,325
22,34,85,78,66,77,362
18,42,43,52,47,27,229
37,51,121,124,126,134,593
11,28,31,26,21,24,141
61,76,197,201,175,173,883
60,71,169,172,148,156,776
33,42,121,119,106,115,536
21,25,73,77,71,80,347
8,27,28,27,22,15,127
2,2,5,6,3,5,23
4,7,3,3,3,3,23
3,5,2,4,3,0,17
4,5,2,2,1,3,17
22,18,58,55,47,64,264
6,5,4,4,7,17,43
7,6,5,5,6,14,43
61,77,200,191,177,179,885
51,68,171,182,153,156,781
59,70,185,187,155,165,821
56,66,182,189,167,170,830
57,71,196,196,162,171,853
52,74,171,159,148,153,757
57,67,178,178,154,163,797
0,38,58,63,41,0,200
0,38,58,63,41,0,200
20,49,49,55,54,41,268
27,29,91,90,67,83,387
24,52,49,54,53,38,270
51,73,192,197,166,167,846
11,13,21,19,13,18,95
57,71,184,187,170,164,833
7,7,16,18,18,22,88
22,28,69,65,60,68,312
64,76,188,195,164,166,853
39,39,101,99,95,102,475
52,72,187,167,140,161,779
1,1,1,2,3,7,15
56,72,185,178,148,166,805
56,69,185,194,165,171,840
3,4,3,6,5,1,22
6,14,8,19,16,8,71
8,25,21,20,23,16,113
12,28,27,35,34,17,153
15,23,55,49,41,54,237
13,27,32,29,29,15,145
13,30,35,31,30,15,154
64,71,182,188,164,166,835
60,74,190,197,171,184,876
49,70,175,185,167,190,836
58,78,187,198,156,154,831
56,70,182,189,159,157,813
0,57,81,70,46,0,254
64,79,198,192,167,171,871
61,67,187,193,164,172,844
59,68,190,202,161,174,854
60,67,181,186,156,180,830
56,66,186,179,149,161,797
50,71,188,189,168,176,842
6,13,10,8,8,2,47
6,7,11,11,7,1,43
7,8,8,10,6,3,42
1,2,1,1,1,2,8
23,26,74,87,73,52,335
21,28,58,65,60,70,302
58,65,181,194,164,158,820
19,30,43,53,39,22,206
50,76,185,188,159,154,812
49,60,166,176,154,171,776
35,46,118,128,99,116,542
42,56,136,138,125,133,630
31,41,112,109,96,98,487
57,63,182,195,167,181,845
67,74,196,197,173,180,887
67,70,198,199,174,193,901
56,67,182,188,171,171,835
60,65,195,185,163,185,853
1,47,67,73,44,0,232
45,54,155,161,132,133,680
9,22,32,33,20,11,127
51,64,171,183,150,161,780
60,71,188,192,166,178,855
62,75,190,188,171,171,857
59,67,174,177,140,163,780
52,62,186,198,172,177,847
56,74,189,190,159,158,826
58,71,180,177,159,170,815
62,66,177,175,154,165,799
49,53,150,157,148,142,699
20,30,68,67,54,51,290
34,45,112,123,114,116,544
55,76,184,190,167,179,851
28,32,79,66,69,69,343
49,72,175,183,160,160,799
63,75,204,212,195,226,975
59,71,188,199,178,186,881
56,77,194,208,183,191,909
65,79,193,199,178,190,904
52,71,162,161,149,154,749
60,73,175,175,158,172,813
44,62,137,134,115,110,602
47,63,145,140,126,128,649
2,0,2,5,3,7,19
10,8,11,9,10,8,56
0,51,71,73,43,0,238
27,58,96,97,78,71,427
34,57,86,96,88,85,446
29,48,78,81,60,36,332
13,30,34,41,29,14,161
54,71,167,178,164,171,805
0,44,69,73,47,0,233
13,20,24,34,30,24,145
55,78,192,200,179,178,882
60,71,190,195,176,160,852
0,49,73,75,49,0,246
55,75,189,189,172,181,861
61,76,183,189,163,173,845
8,22,28,20,19,15,112
0,56,71,70,46,0,243
0,52,76,84,53,0,265
0,53,79,85,52,0,269
0,46,71,82,52,0,251
0,44,67,74,50,0,235
0,50,75,74,47,0,246
12,27,32,29,28,16,144
0,6,13,19,12,0,50
0,25,40,46,28,0,139
0,41,70,73,42,0,226
61,71,192,190,164,160,838
50,70,171,174,157,174,796
50,66,173,183,161,183,816
53,70,179,172,149,160,783
55,65,175,182,160,161,798
54,70,181,180,158,161,804
54,71,186,194,176,174,855
0,54,79,81,54,0,268
0,57,82,85,52,0,276
1,48,65,73,47,0,234
42,48,134,142,132,124,622
41,57,138,133,115,128,612
41,57,138,133,115,128,612
14,24,31,30,29,15,143
56,70,175,187,173,171,832
57,68,183,174,161,169,812
10,25,34,35,30,20,154
61,66,195,202,183,188,895
60,74,195,202,171,197,899
52,63,178,180,155,154,782
57,68,172,178,163,165,803
52,63,172,175,152,160,774
55,71,179,183,168,181,837
50,68,176,186,159,161,800
44,64,162,165,140,146,721
49,70,169,154,140,150,732
46,63,168,165,142,136,720
49,63,162,168,146,150,738
61,83,188,183,166,170,851
16,48,50,52,42,22,230
15,45,44,41,38,19,202
62,81,197,187,165,183,875
24,52,56,51,52,42,277
20,53,54,59,57,39,282
22,56,54,59,56,30,277
22,47,46,59,54,32,260
14,30,28,27,24,16,139
14,30,27,29,28,16,144
60,79,195,191,165,179,869
0,44,71,80,44,0,239
0,43,60,66,46,0,215
0,46,66,74,47,0,233
15,36,40,38,31,15,175
31,33,85,98,87,78,412
26,46,91,86,83,84,416
8,20,23,19,16,7,93
8,15,19,24,18,8,92
9,18,20,28,19,10,104
41,54,142,134,130,147,648
7,22,31,35,30,17,142
0,47,70,73,45,0,235
0,50,70,72,46,0,238
0,42,69,70,44,0,225
13,22,23,25,23,19,125
11,30,30,25,25,12,133
11,23,24,25,21,8,112
11,28,22,23,21,12,117
14,25,21,22,24,15,121
50,61,164,161,143,149,728
14,33,37,33,27,16,160
12,23,24,34,27,15,135
13,29,30,31,30,21,154
5,2,6,2,3,7,25
8,4,9,8,5,6,40
6,6,8,7,4,2,33
8,4,10,4,3,10,39
57,64,183,189,167,163,823
59,73,191,203,184,205,915
53,72,198,206,179,191,899
61,81,203,213,188,209,955
57,71,199,201,177,194,899
55,65,180,193,180,196,869
23,25,66,74,66,66,320
8,12,25,24,24,16,109
36,51,124,120,110,131,572
35,48,119,126,111,132,571
59,75,185,186,181,177,863
61,78,188,188,182,179,876
0,51,65,75,43,0,234
45,56,142,160,138,149,690
7,19,24,27,20,15,112
62,76,195,202,178,186,899
61,66,186,194,185,188,880
8,12,13,19,16,5,73
51,67,177,173,153,156,777
61,74,187,200,179,183,884
66,80,196,208,185,184,919
63,74,201,199,169,179,885
10,19,24,26,23,20,122
10,21,27,26,20,19,123
41,58,134,124,112,126,595
31,37,108,108,103,120,507
0,45,68,64,42,0,219
14,40,76,77,56,36,299
49,57,160,155,133,139,693
9,26,25,29,26,18,133
14,37,39,30,26,15,161
12,27,35,28,25,14,141
16,30,34,30,25,10,145
14,38,36,32,28,16,164
14,34,33,31,29,12,153
14,34,33,31,29,12,153
15,35,26,35,34,21,166
12,25,27,32,27,13,136
16,49,83,85,67,50,350
53,67,177,163,145,161,766
54,61,167,155,138,152,727
58,69,193,196,160,173,849
15,35,30,26,27,12,145
10,31,32,33,35,17,158
25,34,91,91,68,72,381
0,46,68,73,45,0,232
0,57,70,65,41,0,233
19,56,96,98,71,43,383
29,165,163,149,135,46,687
12,30,31,33,30,13,149
13,28,26,27,26,16,136
8,15,23,25,22,14,107
10,25,24,29,26,16,130
0,3,3,2,4,0,12
8,26,20,16,16,13,99
0,50,79,83,47,0,259
60,75,183,192,178,177,865
70,83,192,185,172,184,886
69,82,191,186,174,183,885
16,35,34,35,35,16,171
36,168,178,153,143,70,748
27,31,84,75,65,76,358
16,20,66,71,57,54,284
16,20,66,71,57,54,284
0,54,74,81,51,0,260
0,39,62,64,44,0,209
0,44,64,70,48,0,226
57,70,181,189,151,157,805
