50,66,188,182,146,152,784
22,31,78,83,72,73,359
7,13,34,27,20,25,126
24,36,95,93,57,65,370
45,72,181,184,163,167,812
9,19,38,27,29,31,153
35,57,145,150,127,131,645
18,25,63,70,65,81,322
17,19,70,74,59,80,319
49,67,174,185,160,162,797
18,31,81,90,77,77,374
24,28,65,68,51,70,306
19,25,74,72,66,81,337
22,32,78,89,77,82,380
7,10,23,27,26,19,112
11,19,53,61,50,43,237
12,15,38,45,37,35,182
29,32,79,77,58,54,329
14,19,54,53,39,44,223
16,21,61,66,49,37,250
12,24,61,57,53,60,267
15,20,57,62,57,79,290
36,49,134,138,123,127,607
28,32,83,83,69,57,352
51,67,188,190,164,180,840
16,33,80,80,64,56,329
21,37,93,105,85,86,427
27,35,87,86,76,74,385
50,73,203,188,165,157,836
17,17,37,39,29,34,173
17,24,67,60,52,49,269
43,66,163,165,150,158,745
23,38,94,107,91,74,427
24,32,99,116,90,84,445
47,74,181,199,172,168,841
37,55,127,138,123,131,611
19,30,90,85,63,58,345
19,19,57,65,58,64,282
19,41,118,111,75,68,432
20,43,118,108,72,72,433
39,58,151,146,136,140,670
36,52,137,139,129,139,632
43,65,175,174,152,160,769
50,58,164,158,144,158,732
20,49,119,117,70,66,441
24,35,89,92,83,72,395
25,31,87,90,75,68,376
22,33,100,104,93,94,446
38,61,169,171,144,150,733
5,13,15,17,16,11,77
21,34,92,101,81,72,401
6,6,21,25,20,20,98
40,51,134,120,127,132,604
20,26,80,92,76,73,367
17,26,69,76,66,72,326
18,27,68,77,75,66,331
17,26,86,90,75,87,381
6,6,7,4,6,5,34
24,39,115,100,60,51,389
11,10,33,39,29,24,146
24,29,81,81,70,82,367
16,23,70,64,48,44,265
20,29,76,82,84,84,375
35,47,134,140,128,123,607
20,43,115,113,76,60,427
16,23,72,74,57,54,296
17,25,49,53,55,57,256
14,24,60,72,58,64,292
50,73,179,185,157,172,816
30,35,103,98,88,88,442
26,36,93,95,77,96,423
38,62,158,150,144,147,699
38,60,174,182,171,157,782
48,68,184,181,157,148,786
26,31,78,87,64,68,354
13,15,42,42,39,33,184
25,46,112,116,87,92,478
20,24,67,78,70,76,335
36,50,123,128,111,108,556
25,34,90,85,75,83,392
22,45,118,119,77,71,452
37,54,137,138,114,129,609
34,47,150,146,125,122,624
23,33,89,77,62,55,339
38,61,162,163,146,145,715
18,38,98,98,66,60,378
24,39,121,112,69,61,426
22,40,111,104,71,65,413
39,61,164,152,138,141,695
11,21,61,60,54,50,257
20,32,97,101,98,97,445
27,32,71,75,69,77,351
31,56,126,121,107,121,562
29,41,111,112,83,101,477
37,57,149,152,129,125,649
44,69,184,189,166,171,823
15,32,72,67,61,68,315
12,32,76,71,42,48,281
3,6,14,13,12,13,61
39,40,107,112,96,103,497
46,66,176,182,152,144,766
31,41,105,111,91,81,460
49,70,184,173,142,157,775
27,37,105,99,87,91,446
25,31,91,98,81,92,418
36,57,151,155,148,143,690
20,18,41,42,30,42,193
13,35,96,92,55,51,342
11,14,36,37,26,25,149
31,41,109,113,91,82,467
16,30,95,86,67,58,352
39,64,158,151,144,148,704
26,33,84,85,65,69,362
25,45,134,134,96,66,500
26,47,112,116,87,92,480
18,38,117,113,73,53,412
19,21,71,78,66,67,322
31,38,92,90,92,99,442
19,29,82,68,73,83,354
42,63,167,168,153,156,749
17,33,67,61,56,51,285
24,48,143,151,100,81,547
7,20,58,58,40,32,215
15,19,55,55,53,63,260
37,57,132,133,115,115,589
41,68,173,182,164,157,785
40,58,139,145,144,152,678
28,39,101,110,93,99,470
44,57,176,179,163,155,774
19,46,132,120,80,76,473
8,23,58,59,37,37,222
22,42,119,110,72,63,428
18,45,109,103,79,64,418
34,55,143,137,126,134,629
30,35,89,92,91,90,427
34,53,156,149,134,128,654
43,72,184,174,146,160,779
20,28,79,78,68,58,331
22,51,150,142,95,75,535
9,16,47,66,55,42,235
43,58,178,178,152,143,752
17,26,65,65,55,53,281
4,11,24,36,33,39,147
12,12,33,43,33,32,165
13,16,64,59,46,51,249
8,20,63,68,43,42,244
21,38,91,99,77,99,425
19,41,104,111,96,105,476
18,30,80,80,75,81,364
44,59,165,166,144,147,725
35,46,100,93,79,110,463
33,53,156,144,127,126,639
15,31,96,99,58,63,362
27,31,109,111,71,70,419
20,23,47,60,56,51,257
23,39,91,93,86,81,413
42,69,184,195,165,172,827
34,57,137,139,124,127,618
20,41,102,86,65,62,376
18,25,66,67,61,62,299
11,22,66,54,45,60,258
46,59,171,171,146,145,738
19,39,118,114,72,54,416
18,48,133,125,85,64,473
23,36,95,90,76,69,389
13,21,47,48,36,34,199
5,6,6,7,7,9,40
24,35,98,104,90,91,442
31,23,86,89,76,81,386
50,68,178,175,161,160,792
10,23,55,60,45,54,247
10,29,79,84,49,50,301
45,66,174,166,148,159,758
4,3,10,8,7,8,40
17,15,60,52,38,48,230
37,55,149,157,130,136,664
14,21,61,58,44,40,238
22,30,77,71,66,57,323
45,60,159,163,138,147,712
19,24,50,56,45,57,251
35,48,128,129,112,124,576
26,30,70,74,70,76,346
7,7,13,18,8,5,58
19,47,116,116,83,79,460
16,21,60,65,55,65,282
22,32,81,91,69,73,368
43,60,182,177,156,162,780
48,60,179,165,141,150,743
36,52,156,160,149,148,701
7,6,6,7,6,9,41
10,15,42,62,56,60,245
30,41,111,107,88,93,470
17,21,48,47,40,46,219
48,68,167,172,150,153,758
28,33,84,95,86,96,422
26,31,84,89,72,65,367
26,54,138,123,83,82,506
24,39,121,111,69,60,424
17,48,107,109,77,53,411
20,51,137,131,79,81,499
12,15,29,29,22,19,126
12,17,43,39,30,28,169
25,37,89,99,97,78,425
18,23,67,84,82,91,365
11,8,17,21,19,27,103
6,6,17,22,19,28,98
22,52,135,130,82,63,484
21,30,79,87,82,87,386
14,21,48,49,49,52,233
37,61,162,153,128,134,675
41,53,135,139,134,137,639
11,21,61,59,45,46,243
15,41,89,77,56,55,333
31,34,94,87,69,81,396
20,47,133,131,87,75,493
19,43,132,117,78,80,469
13,23,68,77,55,54,290
51,57,199,193,154,158,812
20,28,67,67,49,57,288
44,64,178,191,166,156,799
38,59,167,167,142,151,724
27,38,91,81,77,88,402
29,33,98,86,86,80,412
18,32,96,98,67,52,363
32,44,101,103,88,92,460
17,40,95,97,85,96,430
23,32,88,97,75,75,390
35,51,121,126,96,111,540
7,13,24,25,26,25,120
10,18,59,65,49,58,259
19,18,63,72,62,59,293
16,19,58,64,56,58,271
25,35,92,101,87,97,437
27,29,78,89,83,85,391
6,7,19,19,18,26,95
36,51,132,132,109,108,568
48,67,173,163,152,174,777
48,63,185,179,161,160,796
38,59,156,154,129,152,688
15,40,110,105,76,68,414
10,12,48,46,30,39,185
8,9,22,22,18,24,103
22,30,79,86,74,81,372
15,32,91,82,52,30,302
19,27,73,88,82,88,377
16,38,100,96,66,55,371
7,13,53,64,63,62,262
31,40,90,92,87,93,433
25,37,101,99,69,77,408
5,10,22,16,15,14,82
30,50,142,149,124,111,606
30,45,141,163,129,134,642
23,39,109,113,75,67,426
45,63,172,186,159,167,792
11,13,54,53,35,33,199
29,35,99,99,84,75,421
22,31,93,97,79,79,401
6,7,5,4,4,4,30
21,40,116,104,70,67,418
26,46,96,96,98,101,463
5,6,20,19,14,16,80
28,37,104,115,100,99,483
42,65,175,180,167,156,785
12,31,95,103,62,41,344
27,34,92,107,94,84,438
29,41,112,113,84,100,479
17,28,84,87,71,68,355
31,47,122,111,93,92,496
35,52,133,138,125,117,600
21,47,136,127,87,67,485
25,43,104,111,99,97,479
43,63,177,178,177,163,801
40,55,176,165,141,137,714
38,52,141,146,131,125,633
22,31,102,104,96,110,465
4,6,15,14,11,15,65
24,48,142,151,94,76,535
21,50,144,128,84,78,505
22,48,107,116,91,85,469
27,37,104,109,87,84,448
29,35,83,88,93,96,424
15,28,92,103,81,65,384
48,66,188,186,165,163,816
27,34,96,83,81,68,389
17,37,97,99,67,58,375
10,21,57,48,38,37,211
41,66,168,166,155,143,739
11,20,38,31,25,33,158
34,49,141,132,107,120,583
38,62,165,168,137,144,714
19,29,75,66,49,57,295
15,21,61,54,49,53,253
36,49,117,125,109,109,545
24,39,88,93,84,89,417
19,29,55,54,44,44,245
43,51,125,130,124,133,606
16,37,119,131,80,65,448
25,39,94,95,86,88,427
5,8,34,47,41,31,166
39,48,124,117,90,100,518
6,7,29,30,31,33,136
12,20,53,48,49,47,229
35,58,145,150,135,127,650
35,53,156,160,138,137,679
36,51,132,132,108,105,564
14,19,71,78,54,41,277
17,42,99,101,68,63,390
33,42,108,111,101,101,496
3,4,9,5,2,6,29
12,14,43,39,37,48,193
18,32,80,82,67,79,358
33,52,129,132,125,128,599
21,27,78,94,72,80,372
43,59,163,163,140,142,710
31,39,102,102,89,90,453
25,47,134,137,91,71,505
36,57,133,133,118,131,608
41,59,162,179,140,136,717
17,44,104,99,80,70,414
25,36,86,78,60,61,346
47,67,177,173,157,173,794
34,51,128,128,103,116,560
20,29,91,84,83,98,405
44,63,172,168,150,162,759
42,64,187,183,155,167,798
45,64,162,167,161,154,753
24,27,89,96,74,61,371
11,15,38,38,30,28,160
37,51,136,141,132,110,607
30,39,115,108,87,113,492
36,57,167,171,152,145,728
6,5,2,3,4,14,34
22,41,105,97,77,80,422
18,25,77,77,70,67,334
34,54,138,148,138,140,652
21,43,132,123,92,70,481
7,15,35,44,35,24,160
12,37,95,94,52,49,339
15,42,119,128,87,65,456
40,63,161,162,131,126,683
24,35,101,102,90,99,451
38,46,144,144,134,140,646
21,36,85,91,77,77,387
23,32,86,88,83,88,400
19,30,66,76,71,83,345
12,19,52,60,58,58,259
44,63,172,168,150,162,759
52,63,188,194,170,177,844
3,3,5,5,5,3,24
37,59,153,155,152,158,714
19,38,106,121,88,68,440
43,59,163,160,142,142,709
23,40,112,111,94,103,483
26,27,78,79,67,82,359
9,32,79,84,62,43,309
2,2,8,3,3,9,27
18,21,61,67,63,58,288
6,9,23,17,12,19,86
22,25,66,70,59,63,305
21,29,76,78,61,55,320
13,30,90,84,62,56,335
21,25,67,68,52,66,299
22,32,69,82,80,101,386
23,37,101,105,83,100,449
21,31,81,96,90,91,410
20,32,78,73,55,58,316
24,31,81,90,87,77,390
19,32,76,79,55,62,323
26,31,75,86,81,69,368
1,1,5,7,7,6,27
2,5,12,12,11,6,48
2,5,12,16,7,10,52
25,35,77,86,70,71,364
21,27,77,83,81,91,380
46,59,171,171,160,147,754
22,33,78,78,59,64,334
15,24,64,61,52,38,254
9,13,32,34,41,45,174
36,51,146,145,131,144,653
45,62,171,161,137,144,720
14,17,67,78,51,37,264
35,48,136,148,119,120,606
44,66,150,148,125,123,656
45,57,177,172,156,144,751
19,41,112,105,75,60,412
43,53,154,156,136,126,668
39,58,155,157,138,126,673
3,3,5,6,5,5,27
39,50,155,152,131,135,662
4,4,12,22,15,13,70
33,47,144,152,119,125,620
34,56,135,142,127,126,620
16,28,78,76,63,76,337
27,35,87,86,74,73,382
25,43,108,108,96,105,485
16,44,96,86,56,53,351
34,52,145,153,139,136,659
11,15,39,49,38,37,189
38,52,134,152,129,131,636
9,24,60,51,39,24,207
48,60,172,164,144,139,727
34,57,142,147,122,128,630
9,12,39,55,45,40,200
21,30,86,83,74,95,389
44,60,146,142,123,128,643
24,27,74,77,60,64,326
35,52,126,134,119,124,590
16,38,97,96,66,55,368
36,52,132,146,128,127,621
37,52,157,166,141,142,695
17,22,79,77,57,81,333
30,42,120,136,126,123,577
42,58,149,153,130,133,665
34,41,112,121,101,93,502
2,3,3,0,1,0,9
14,30,92,94,64,59,353
22,45,114,105,68,61,415
12,13,41,37,36,48,187
1,2,4,6,6,8,27
21,20,49,55,49,51,245
24,38,97,128,125,125,537
16,32,114,123,82,60,427
2,4,14,10,5,6,41
7,10,17,17,18,14,83
2,1,4,5,5,2,19
22,41,109,95,74,67,408
45,69,181,179,155,159,788
22,24,81,87,71,70,355
27,34,89,86,79,85,400
10,10,35,38,38,24,155
45,49,152,165,161,147,719
21,46,104,104,68,62,405
14,36,103,99,63,48,363
20,31,64,53,43,45,256
36,51,157,167,161,165,737
3,6,6,5,4,7,31
40,54,144,149,131,130,648
2,5,8,6,5,13,39
46,62,176,176,152,162,774
27,36,80,92,93,97,425
3,2,9,8,4,9,35
31,48,149,153,109,105,595
16,28,76,61,46,49,276
13,25,73,73,54,58,296
39,63,168,162,152,152,736
10,14,46,51,27,25,173
16,27,71,66,59,80,319
23,37,95,100,82,74,411
43,56,169,172,141,154,735
3,3,3,0,3,3,15
21,41,102,100,63,54,381
10,12,42,48,38,39,189
27,34,93,101,77,83,415
8,8,32,45,25,24,142
11,6,26,32,30,33,138
30,51,130,138,111,124,584
39,58,161,156,145,148,707
4,2,5,3,3,8,25
17,33,113,101,60,53,377
32,45,135,140,116,122,590
43,62,160,163,139,132,699
47,64,182,177,152,156,778
16,38,109,104,63,58,388
5,3,8,6,9,23,54
10,19,50,57,43,24,203
44,57,171,170,165,158,765
15,35,96,108,65,54,373
2,4,9,14,9,9,47
4,7,7,7,6,4,35
32,36,121,124,102,104,519
37,59,165,161,153,147,722
33,51,137,130,101,117,569
44,66,180,180,177,171,818
30,54,128,137,115,103,567
42,49,147,148,136,143,665
42,64,149,147,124,122,648
38,51,146,144,120,126,625
26,45,104,121,101,107,504
18,29,81,86,66,59,339
21,43,117,111,79,71,442
45,63,160,154,145,160,727
13,19,71,55,38,61,257
36,52,142,139,120,130,619
45,49,152,166,162,147,721
5,6,21,26,19,14,91
19,17,65,79,58,82,320
6,11,25,33,27,13,115
36,56,154,159,142,151,698
18,43,137,140,92,87,517
3,5,5,3,0,2,18
40,54,147,153,127,131,652
14,45,107,95,61,51,373
56,66,176,187,171,164,820
4,4,2,4,3,1,18
31,49,108,106,96,99,489
21,36,91,106,100,96,450
42,54,158,169,150,145,718
10,14,46,44,25,19,158
17,27,79,87,91,73,374
29,45,129,135,123,136,597
46,62,174,179,152,163,776
26,35,86,91,75,82,395
41,55,137,144,136,127,640
2,9,12,16,12,6,57
33,51,138,153,132,124,631
39,45,143,158,131,110,626
41,59,167,162,146,151,726
4,3,4,2,3,2,18
47,68,175,177,164,152,783
44,65,171,179,156,164,779
45,63,157,148,141,147,701
43,62,170,172,145,148,740
2,2,3,5,2,5,19
3,3,5,3,2,7,23
11,22,57,66,54,43,253
10,19,42,44,45,40,200
29,44,115,124,109,113,534
42,59,159,159,144,136,699
3,1,3,5,5,11,28
36,57,151,153,130,146,673
11,33,100,101,70,67,382
42,59,170,182,154,161,768
28,35,98,107,93,83,444
33,54,147,147,132,137,650
5,10,18,12,7,13,65
46,58,159,165,157,146,731
7,10,20,16,10,17,80
18,44,116,141,103,84,506
35,46,138,148,135,136,638
22,40,98,81,77,77,395
38,42,133,149,129,140,631
25,32,85,83,77,81,383
47,67,178,175,163,157,787
4,6,16,29,25,21,101
24,44,136,136,108,107,555
17,27,81,80,73,69,347
24,32,70,77,67,69,339
39,49,134,131,116,132,601
15,30,78,81,61,47,312
35,55,144,146,130,128,638
42,64,175,162,154,159,756
10,30,85,88,46,54,313
44,55,158,171,148,148,724
22,35,93,107,91,91,439
29,44,127,129,106,132,567
4,6,18,26,22,17,93
43,61,172,160,134,130,700
19,40,104,100,70,56,389
28,38,97,92,82,85,422
16,37,101,107,88,58,407
1,2,7,19,16,10,55
46,59,157,150,128,156,696
39,54,158,151,128,132,662
0,2,4,1,2,0,9
22,32,74,81,60,55,324
22,26,75,80,73,71,347
25,30,88,88,70,75,376
19,43,137,134,98,91,522
16,18,57,65,49,46,251
9,13,51,52,38,42,205
31,51,157,168,106,87,600
18,28,73,72,60,76,327
29,71,203,210,138,104,755
2,2,3,3,2,2,14
2,3,3,3,0,0,11
32,41,105,117,93,92,480
30,56,172,160,112,102,632
33,70,195,163,106,101,668
27,42,110,100,73,87,439
26,42,101,102,92,85,448
21,33,87,74,64,60,339
24,47,141,141,96,80,529
12,15,57,61,40,37,222
8,5,4,5,7,6,35
12,12,52,56,45,46,223
0,1,3,3,1,6,14
11,13,47,44,35,25,175
22,51,143,145,92,73,526
32,69,189,189,125,104,708
19,27,62,60,68,74,310
24,49,137,137,98,86,531
17,40,105,96,62,45,365
16,19,46,46,38,32,197
3,3,5,2,3,6,22
14,13,45,50,46,42,210
16,28,73,67,70,68,322
24,40,102,108,81,83,438
1,8,13,9,10,6,47
6,6,7,9,7,7,42
21,39,91,89,81,68,389
26,33,88,71,59,79,356
23,37,84,92,89,100,425
13,14,49,47,33,37,193
21,46,133,136,87,71,494
17,31,83,85,74,87,377
14,36,105,98,56,52,361
33,63,191,183,124,106,700
8,9,8,8,6,8,47
20,39,106,97,72,68,402
0,1,2,0,0,6,9
32,61,193,188,124,101,699
4,5,14,7,2,13,45
25,50,166,165,100,85,591
17,31,81,96,97,100,422
16,17,58,54,44,37,226
20,31,121,118,80,60,430
24,52,146,149,105,81,557
36,67,194,190,127,116,730
13,26,61,62,58,64,284
0,1,3,3,2,0,9
26,27,95,113,98,82,441
23,27,65,79,85,78,357
15,13,45,51,45,43,212
23,25,86,91,77,72,374
18,26,65,57,52,53,271
25,38,98,100,83,88,432
20,29,93,115,99,79,435
38,74,193,196,129,114,744
11,27,89,85,51,58,321
23,35,90,94,80,72,394
20,44,125,109,67,56,421
20,26,82,85,75,85,373
35,68,194,185,123,91,696
22,38,98,95,74,82,409
19,14,50,54,46,40,223
22,25,73,71,65,72,328
8,10,41,38,23,39,159
17,21,57,67,54,42,258
13,15,32,22,27,28,137
7,4,6,6,3,17,43
20,22,70,59,55,59,285
33,68,202,203,137,105,748
23,51,143,137,92,66,512
8,14,38,50,38,29,177
2,3,5,3,7,3,23
35,65,204,201,136,102,743
2,2,5,7,7,10,33
0,0,3,3,1,4,11
8,35,97,105,71,50,366
16,19,60,64,46,41,246
31,58,174,180,114,91,648
7,8,10,14,10,10,59
21,47,124,119,84,58,453
25,54,151,146,101,85,562
21,43,98,86,77,75,400
22,54,139,136,86,66,503
20,30,75,78,67,81,351
9,15,41,51,42,35,193
32,59,184,187,132,105,699
30,42,120,121,105,104,522
2,1,3,5,3,7,21
1,1,4,4,6,2,18
16,37,118,129,80,64,444
22,35,73,77,66,50,323
24,29,78,89,75,82,377
30,42,111,120,105,99,507
4,4,4,5,4,8,29
13,19,50,47,38,32,199
24,32,79,90,85,99,409
13,44,110,105,70,65,407
11,13,48,46,33,36,187
12,12,43,40,36,33,176
28,52,157,169,110,91,607
4,6,6,7,6,3,32
1,0,0,1,2,3,7
24,51,157,171,131,87,621
18,26,80,86,61,77,348
2,3,6,4,6,2,23
31,40,109,121,103,99,503
37,69,200,217,138,111,772
20,36,85,85,81,70,377
3,2,4,2,4,4,19
3,2,3,6,2,3,19
2,3,2,3,2,5,17
12,20,58,59,39,43,231
14,9,40,37,29,35,164
19,32,106,106,77,68,408
0,1,1,0,0,0,2
25,50,150,159,107,87,578
9,22,53,49,32,30,195
8,11,43,41,31,34,168
14,16,44,39,32,26,171
7,6,3,2,2,3,23
31,40,101,111,97,102,482
4,6,6,6,5,3,30
8,9,28,41,27,24,137
16,38,104,87,64,46,355
14,25,76,79,58,70,322
7,8,12,13,14,15,69
6,9,29,28,22,20,114
27,31,85,97,82,85,407
4,4,6,2,1,3,20
5,7,6,6,5,9,38
35,57,170,171,118,106,657
29,41,111,120,108,116,525
5,5,6,9,7,6,38
17,37,89,102,97,91,433
35,58,185,175,116,103,672
25,34,89,94,81,83,406
0,0,0,1,2,0,3
26,36,87,72,67,88,376
8,14,47,45,36,40,190
26,52,162,169,118,92,619
12,11,41,37,34,29,164
30,56,159,154,108,84,591
9,13,49,54,37,38,200
16,21,53,59,51,39,239
28,47,157,161,111,79,583
17,37,114,123,78,62,431
35,67,195,187,130,102,716
17,21,59,60,47,40,244
23,23,56,42,41,45,230
17,25,60,75,65,57,299
14,33,86,93,69,45,340
31,57,166,155,113,86,608
5,4,4,5,3,8,29
13,21,58,59,55,48,254
23,40,98,109,99,103,472
18,33,72,85,80,76,364
39,57,146,159,128,130,659
16,20,56,60,59,63,274
43,61,158,159,135,146,702
4,1,5,5,4,8,27
8,15,30,19,22,21,115
15,17,45,45,33,32,187
25,26,107,110,90,90,448
28,38,91,93,78,77,405
19,29,77,78,70,74,347
23,30,92,101,83,82,411
45,59,150,150,136,142,682
24,32,92,102,86,92,428
28,39,113,130,107,98,515
29,39,98,95,86,96,443
24,35,87,92,84,78,400
2,4,10,7,5,10,38
44,62,160,166,132,143,707
32,40,105,116,97,92,482
33,64,165,167,133,140,702
2,3,3,6,7,1,22
18,29,77,81,82,79,366
25,31,78,87,85,94,400
26,41,116,127,106,98,514
15,23,58,64,54,59,273
20,34,83,90,79,69,375
36,68,142,153,137,145,681
35,42,128,138,116,118,577
43,56,147,139,112,122,619
29,42,118,107,88,101,485
46,55,149,153,134,142,679
48,62,163,155,135,149,712
31,52,121,136,119,127,586
45,49,133,147,130,129,633
37,71,210,187,116,104,725
0,0,1,4,5,1,11
29,39,111,96,95,110,480
20,21,76,80,73,69,339
1,1,2,2,2,3,11
33,68,197,197,128,101,724
37,51,130,144,121,120,603
26,52,121,125,111,105,540
14,17,50,57,55,56,249
39,54,142,157,137,141,670
37,50,138,142,121,136,624
34,41,127,121,110,111,544
7,11,16,20,23,25,102
39,54,134,147,116,124,614
28,36,86,89,83,82,404
28,37,98,103,88,86,440
5,6,11,11,14,17,64
22,36,79,76,71,77,361
32,45,121,130,118,113,559
44,50,144,140,120,120,618
39,55,142,151,116,115,618
10,12,31,35,29,34,151
45,53,136,143,135,124,636
6,2,5,2,1,6,22
47,59,147,145,132,139,669
31,33,88,92,93,94,431
29,42,112,129,114,112,538
36,46,128,139,113,120,582
42,56,163,173,148,156,738
27,35,103,98,88,96,447
18,19,60,61,41,50,249
3,5,18,20,13,15,74
3,4,7,6,4,8,32
40,58,143,150,135,144,670
1,1,4,6,7,2,21
44,56,135,141,113,131,620
23,25,78,84,76,83,369
27,40,110,108,108,112,505
33,40,114,124,108,111,530
19,26,66,74,72,66,323
35,54,120,139,128,128,604
25,43,116,115,99,88,486
16,18,52,52,39,42,219
18,36,95,84,75,86,394
1,2,1,2,2,0,8
50,59,156,147,115,116,643
38,55,160,165,143,137,698
45,59,153,153,128,145,683
31,47,124,134,117,119,572
29,35,99,90,86,81,420
33,42,125,138,116,104,558
15,20,50,53,48,49,235
38,51,128,122,116,106,561
39,56,142,130,115,113,595
6,5,15,15,8,15,64
28,68,198,186,124,95,699
18,22,59,58,47,57,261
36,51,126,138,126,132,609
45,67,171,173,145,151,752
2,1,4,7,2,2,18
13,22,57,55,42,58,247
29,33,97,97,82,65,403
3,2,5,3,5,7,25
4,2,6,5,4,6,27
30,42,112,110,84,95,473
38,56,143,142,120,129,628
49,56,166,160,139,154,724
39,52,136,142,125,126,620
28,41,108,106,108,111,502
39,50,126,138,124,126,603
27,40,110,107,107,112,503
21,30,69,82,77,78,357
30,49,126,137,117,109,568
24,26,103,111,95,100,459
5,5,3,6,5,7,31
36,52,136,146,120,129,619
40,46,135,154,135,138,648
42,49,140,161,136,144,672
29,42,111,121,96,93,492
32,46,110,115,102,93,498
8,17,44,49,47,49,214
6,11,26,27,22,14,106
20,32,100,105,91,101,449
23,32,84,95,86,71,391
36,55,143,127,106,121,588
32,41,123,133,114,107,550
50,59,158,160,137,153,717
26,38,90,91,78,79,402
43,62,158,157,130,136,686
32,51,118,112,101,106,520
0,2,4,6,6,7,25
31,45,138,138,110,105,567
45,59,175,170,150,149,748
38,60,178,171,110,107,664
39,50,131,142,121,128,611
27,48,120,123,107,127,552
3,3,3,7,4,6,26
1,1,3,2,1,3,11
37,55,135,139,114,122,602
34,42,124,111,103,114,528
13,18,46,42,35,46,200
21,33,81,73,64,71,343
44,55,162,165,141,148,715
29,45,105,97,91,93,460
47,63,156,165,136,151,718
3,5,8,10,7,6,39
31,56,193,187,137,111,715
36,51,125,133,129,118,592
33,40,110,118,110,106,517
6,13,25,26,21,23,114
0,4,5,2,2,3,16
5,9,23,33,32,30,132
6,13,31,37,26,25,138
4,10,15,15,11,11,66
0,36,58,66,44,0,204
0,0,0,1,0,0,1
0,35,61,68,36,0,200
0,33,69,70,37,0,209
0,38,62,56,35,0,191
0,29,46,50,33,0,158
0,10,15,19,13,0,57
0,17,29,29,20,0,95
0,32,50,55,32,0,169
0,25,35,35,23,0,118
0,28,42,54,35,0,159
0,21,31,32,20,0,104
0,4,10,8,2,0,24
0,8,16,12,7,0,43
0,30,51,56,36,0,173
0,0,2,3,2,0,7
0,31,52,60,35,0,178
0,1,1,4,3,0,9
0,31,45,54,36,0,166
0,31,50,56,31,0,168
0,35,48,54,37,0,174
0,1,1,1,0,0,3
0,25,34,36,22,0,117
0,32,50,54,31,0,167
0,32,47,59,37,0,175
0,0,1,4,4,0,9
0,32,47,55,35,0,169
0,25,33,35,25,0,118
0,36,53,56,32,0,177
0,1,2,3,0,0,6
0,32,49,58,36,0,175
0,33,49,51,27,0,160
0,23,37,36,20,0,116
0,22,29,27,19,0,97
0,27,40,41,24,0,132
0,28,45,51,31,0,155
0,26,43,54,35,0,158
0,28,44,50,31,0,153
0,27,40,44,28,0,139
0,36,52,51,33,0,172
0,32,49,51,31,0,163
0,34,49,53,32,0,168
0,5,9,8,4,0,26
0,32,51,55,32,0,170
0,31,47,60,39,0,177
0,30,52,56,34,0,172
0,25,43,40,25,0,133
0,33,49,48,32,0,162
0,1,1,0,0,0,2
0,31,43,54,37,0,165
0,30,52,56,34,0,172
0,31,49,51,33,0,164
0,13,15,21,13,0,62
0,4,8,11,7,0,30
0,37,59,58,35,0,189
0,27,44,56,37,0,164
0,13,21,25,17,0,76
0,30,45,62,39,0,176
0,5,5,9,8,0,27
0,22,35,40,27,0,124
0,30,50,56,37,0,173
0,26,44,48,32,0,150
0,2,4,12,10,0,28
0,0,0,1,1,0,2
0,11,19,24,13,0,67
0,15,27,33,20,0,95
0,31,43,53,31,0,158
0,5,8,13,9,0,35
0,4,4,4,3,0,15
0,22,31,34,21,0,108
0,14,19,16,7,0,56
0,26,45,57,33,0,161
0,2,2,2,2,0,8
19,20,40,39,29,36,183
40,68,174,186,156,153,777
29,47,97,91,79,93,436
12,17,32,36,25,30,152
38,59,144,149,122,145,657
39,63,158,163,140,145,708
47,69,185,177,155,155,788
44,64,167,169,168,163,775
48,70,173,174,148,154,767
27,44,99,110,103,100,483
12,20,44,45,34,35,190
53,74,196,197,167,181,868
6,7,29,30,31,33,136
40,54,138,135,119,138,624
39,53,155,180,152,149,728
53,74,196,197,167,181,868
54,62,180,190,166,180,832
48,67,172,181,156,147,771
47,71,181,179,151,141,770
11,15,32,29,27,31,145
10,19,46,49,35,33,192
9,21,38,48,41,28,185
47,69,178,179,165,156,794
8,10,26,38,33,29,144
52,72,175,196,180,150,825
41,61,166,192,144,144,748
48,71,173,178,170,172,812
49,71,185,182,174,170,831
12,18,46,51,45,44,216
37,62,155,149,123,142,668
47,69,197,207,171,172,863
29,42,112,114,93,101,491
47,65,175,175,171,180,813
15,19,37,43,30,32,176
14,18,45,49,42,37,205
24,45,123,123,104,115,534
32,46,150,151,130,146,655
45,62,171,175,150,147,750
35,52,153,158,127,131,656
25,34,96,90,74,94,413
24,50,142,142,97,80,535
28,40,97,99,88,90,442
42,61,151,174,142,140,710
12,10,37,54,44,33,190
35,55,150,162,129,143,674
34,59,138,142,143,138,654
7,11,33,40,35,25,151
42,61,151,174,142,139,709
50,66,175,178,161,160,790
40,63,175,171,151,156,756
54,72,181,183,161,163,814
51,60,173,178,161,170,793
39,58,157,178,149,162,743
11,15,29,45,35,31,166
50,60,151,172,154,154,741
44,63,174,167,164,179,791
38,64,170,191,183,175,821
17,27,65,64,56,51,280
10,15,36,47,32,40,180
46,73,178,187,176,162,822
47,68,188,184,157,172,816
13,16,40,44,37,33,183
51,70,181,170,157,175,804
42,61,153,155,125,134,670
44,60,173,171,146,150,744
49,71,180,178,173,184,835
37,50,127,151,129,123,617
2,1,4,7,3,4,21
51,66,172,177,165,158,789
48,80,190,205,164,175,862
50,69,186,180,153,149,787
49,67,174,178,157,157,782
45,75,182,181,156,164,803
50,68,186,193,175,179,851
34,56,146,156,138,147,677
48,54,164,172,141,155,734
28,44,111,104,91,92,470
51,68,175,182,161,170,807
24,41,98,92,81,80,416
42,60,150,149,125,117,643
41,61,156,151,128,146,683
46,64,180,189,158,167,804
46,72,181,190,161,158,808
16,21,41,50,42,40,210
41,58,138,154,135,140,666
49,64,176,187,171,160,807
41,65,177,177,138,152,750
17,20,44,47,37,30,195
15,17,46,45,32,42,197
16,33,84,91,79,92,395
43,63,176,177,151,150,760
18,29,68,74,67,64,320
35,50,137,148,128,145,643
44,64,161,169,141,144,723
44,57,157,161,136,140,695
36,53,142,146,123,132,632
19,27,62,61,43,44,256
49,73,183,185,144,152,786
24,28,60,73,67,67,319
31,47,120,120,99,118,535
36,59,153,155,131,141,675
40,64,179,175,149,152,759
55,65,181,189,166,180,836
22,35,83,85,71,78,374
46,63,159,164,140,145,717
46,67,167,178,167,174,799
40,63,145,164,137,156,705
38,65,154,152,138,133,680
36,55,138,151,131,136,647
34,52,134,133,116,132,601
12,21,38,40,33,40,184
44,67,168,186,167,171,803
36,54,138,141,113,130,612
42,62,166,176,153,155,754
11,15,38,40,34,30,168
32,35,87,86,86,86,412
50,73,190,190,163,168,834
47,67,180,191,160,174,819
49,70,186,179,158,152,794
13,14,41,45,34,33,180
39,56,146,143,123,143,650
46,63,172,186,170,156,793
6,14,33,30,24,28,135
13,16,35,37,28,38,167
39,62,162,171,154,149,737
45,67,181,183,171,183,830
14,16,43,50,45,33,201
46,66,172,189,163,167,803
37,51,142,156,134,151,671
45,62,173,185,161,183,809
47,74,174,180,155,153,783
54,69,186,192,171,177,849
38,53,137,128,115,121,592
0,30,49,64,42,8,193
49,70,180,186,167,178,830
44,70,175,194,163,168,814
24,46,115,127,110,106,528
42,66,173,177,156,168,782
18,35,75,87,90,73,378
2,1,1,3,3,1,11
3,3,4,7,6,4,27
53,70,181,180,150,149,783
52,72,180,195,172,163,834
49,72,186,191,160,159,817
46,62,171,188,167,162,796
20,24,82,89,75,87,377
48,68,185,182,158,170,811
44,66,184,200,174,185,853
48,64,180,183,158,170,803
49,70,184,187,162,164,816
54,72,191,189,164,174,844
49,74,183,188,163,166,823
50,65,177,185,155,159,791
49,69,178,190,166,171,823
44,70,186,187,159,156,802
44,70,186,187,159,156,802
50,65,177,185,155,159,791
55,71,188,187,170,183,854
47,71,185,190,166,165,824
1,0,1,0,1,1,4
50,62,178,189,169,168,816
46,65,175,171,156,164,777
51,70,190,190,155,165,821
47,65,160,160,149,158,739
51,67,175,192,161,178,824
46,67,173,179,164,158,787
52,69,170,186,161,168,806
48,67,186,184,161,156,802
50,75,181,189,163,175,833
40,69,180,200,170,172,831
51,68,178,188,156,163,804
46,63,171,185,166,178,809
55,74,193,195,163,169,849
52,70,178,184,169,188,841
44,66,175,183,155,165,788
45,63,171,180,159,156,774
6,11,41,39,30,29,156
21,37,110,113,85,60,426
35,57,172,169,117,105,655
16,23,61,64,49,40,253
15,12,50,50,44,40,211
31,42,100,97,95,110,475
16,25,64,59,52,45,261
13,15,55,52,44,38,217
29,36,97,96,75,73,406
26,51,166,172,109,98,622
27,33,98,95,91,69,413
30,48,105,101,92,115,491
32,46,138,151,130,139,636
54,71,178,171,153,162,789
34,35,92,92,82,102,437
45,55,160,164,137,139,700
24,30,91,97,79,92,413
42,53,156,166,150,151,718
46,60,156,165,152,163,742
46,63,165,173,156,158,761
48,63,176,178,148,159,772
470,1234,2468,2482,1951,2453,11058
35,49,140,144,127,126,621
44,66,172,171,149,154,756
17,30,82,85,72,88,374
17,28,66,69,63,76,319
48,68,179,185,162,171,813
47,63,177,175,149,159,770
23,38,90,81,57,71,360
24,39,96,113,98,99,469
35,41,93,90,83,78,420
53,74,191,178,150,160,806
17,24,71,72,54,67,305
34,54,126,129,101,99,543
45,72,201,199,163,175,855
44,54,154,157,149,142,700
44,60,169,166,152,165,756
19,32,80,75,71,73,350
379,944,1915,1918,1488,1883,8527
23,37,92,103,88,95,438
46,68,176,193,158,167,808
36,58,143,150,128,130,645
25,28,89,102,79,87,410
25,24,78,76,65,62,330
23,38,95,106,90,74,426
24,30,89,84,64,79,370
40,59,150,147,124,136,656
34,44,112,112,105,110,517
51,69,190,191,154,157,812
21,17,56,65,62,66,287
19,31,89,87,82,71,379
41,60,154,159,137,137,688
32,50,118,106,101,95,502
29,48,125,126,108,133,569
41,62,160,159,146,149,717
59,68,199,191,165,156,838
17,25,64,68,60,70,304
31,40,110,122,101,97,501
31,40,108,95,80,95,449
39,66,158,150,131,142,686
46,66,182,171,147,144,756
19,36,95,82,65,64,361
50,66,177,187,158,150,788
41,60,174,184,153,173,785
48,63,182,199,171,163,826
55,63,186,190,165,170,829
51,66,180,186,162,169,814
28,38,122,110,103,112,513
32,55,145,145,126,118,621
38,51,142,154,125,138,648
30,43,98,100,94,98,463
23,24,67,71,70,84,339
38,62,141,143,122,126,632
28,34,100,108,100,116,486
20,19,69,80,77,80,345
31,43,122,134,113,113,556
52,70,188,190,162,166,828
23,26,73,73,61,80,336
48,68,176,169,151,165,777
20,24,65,65,59,61,294
39,69,173,170,143,158,752
35,61,138,143,120,124,621
24,40,99,96,73,84,416
26,40,111,107,100,111,495
36,52,123,133,123,114,581
42,51,154,166,132,141,686
44,56,157,146,136,135,674
41,53,135,129,133,141,632
38,45,143,136,118,122,602
24,33,106,112,87,100,462
15,29,82,87,86,88,387
32,46,140,143,127,129,617
39,57,148,148,132,138,662
44,64,165,176,147,136,732
46,63,161,162,141,151,724
40,57,155,163,126,138,679
30,45,106,116,101,113,511
46,58,163,161,138,145,711
38,57,158,171,144,140,708
54,76,199,207,169,147,852
24,34,85,86,80,97,406
53,70,178,187,162,168,818
45,62,178,191,157,161,794
39,52,138,142,126,138,635
40,57,146,142,114,119,618
23,31,79,75,72,83,363
20,30,79,91,82,70,372
23,40,108,105,85,100,461
34,57,137,135,125,139,627
38,57,153,162,144,132,686
46,63,159,181,169,166,784
5,4,6,5,6,4,30
36,47,136,136,110,109,574
33,44,129,134,120,133,593
32,56,142,153,133,136,652
35,41,124,131,117,130,578
31,43,102,108,97,102,483
38,57,145,149,133,128,650
26,47,113,108,88,98,480
29,44,104,121,117,117,532
28,39,101,105,88,92,453
2,3,5,10,7,9,36
37,49,131,129,117,119,582
36,59,150,152,135,149,681
48,64,164,174,151,150,751
26,41,118,114,101,100,500
22,39,110,103,91,109,474
29,42,108,125,99,96,499
29,40,88,85,91,106,439
30,45,138,150,128,136,627
18,27,71,75,64,68,323
30,36,91,91,83,77,408
16,22,59,68,69,64,298
21,26,67,68,53,65,300
25,30,92,112,102,73,434
33,50,111,112,93,106,505
41,68,170,169,149,154,751
44,61,179,169,152,155,760
14,20,56,59,39,48,236
49,63,188,187,166,176,829
36,58,142,141,116,131,624
49,63,173,170,152,148,755
46,65,185,187,163,162,808
35,48,130,138,114,118,583
34,60,142,141,122,145,644
50,71,199,198,172,165,855
997,2718,5425,5461,4390,5373,24364
34,48,126,111,87,95,501
53,72,182,188,159,165,819
46,71,176,176,163,171,803
46,58,178,163,156,157,758
42,64,179,186,161,161,793
48,66,195,203,174,167,853
3,1,7,7,8,5,31
45,58,152,159,129,144,687
47,66,188,197,163,167,828
40,60,161,170,143,139,713
31,46,122,126,101,111,537
34,55,135,130,113,115,582
46,63,166,168,151,166,760
33,50,124,132,121,124,584
46,70,171,174,154,161,776
54,72,184,190,175,155,830
43,63,170,188,159,153,776
31,45,130,133,122,128,589
0,32,53,65,36,0,186
34,54,127,131,115,117,578
46,59,150,163,145,143,706
32,52,124,115,107,105,535
54,63,168,176,158,156,775
35,51,148,163,137,139,673
47,68,190,189,168,167,829
50,65,195,203,176,167,856
31,48,130,138,117,135,599
41,59,171,168,141,142,722
29,40,131,147,117,114,578
43,71,182,192,170,154,812
53,70,188,194,165,185,855
121,210,488,484,430,483,2216
28,44,115,117,108,112,524
47,58,182,175,157,144,763
35,60,141,149,140,142,667
41,58,152,172,156,140,719
32,54,129,127,112,120,574
32,49,121,129,112,104,547
44,72,180,192,171,154,813
50,67,197,192,174,174,854
13,20,52,51,46,38,220
51,77,187,184,165,174,838
45,69,178,176,148,167,783
47,71,182,184,167,162,813
54,63,179,176,164,159,795
41,49,132,131,108,107,568
45,57,177,177,156,161,773
43,62,153,170,154,150,732
49,63,167,173,156,159,767
44,66,187,186,166,176,825
43,73,180,175,160,167,798
0,33,55,62,34,2,186
48,58,163,161,140,156,726
41,70,191,188,164,161,815
40,62,148,157,143,142,692
37,46,130,131,111,121,576
12,39,91,82,50,31,305
50,63,168,180,144,149,754
53,71,179,187,161,164,815
40,49,129,139,120,124,601
31,41,107,121,96,105,501
38,56,150,157,141,146,688
30,39,123,124,88,96,500
24,37,103,116,102,102,484
32,49,127,128,108,130,574
44,59,165,181,149,166,764
36,52,125,132,113,108,566
43,54,144,167,137,134,679
44,66,169,180,167,154,780
39,64,149,153,129,133,667
46,65,176,184,159,165,795
45,64,182,179,150,159,779
33,45,120,134,118,129,579
40,46,130,129,114,121,580
42,67,166,170,146,147,738
0,33,69,68,33,0,203
47,75,179,171,154,157,783
26,57,154,137,99,91,564
40,47,114,110,106,117,534
54,74,209,208,170,174,889
20,18,58,64,57,47,264
10,40,117,116,73,53,409
20,23,69,58,49,48,267
41,57,159,167,149,152,725
6,36,63,76,40,11,232
0,35,64,68,42,0,209
16,18,60,68,53,46,261
34,43,123,119,111,114,544
29,50,124,118,103,110,534
37,54,135,145,126,136,633
45,71,185,189,163,170,823
40,47,146,162,139,145,679
22,45,136,153,88,71,515
14,22,57,56,52,47,248
45,70,194,205,162,160,836
27,50,122,122,89,83,493
0,37,57,71,40,0,205
16,22,57,60,54,57,266
15,17,61,66,53,51,263
18,21,57,70,50,44,260
47,60,171,172,155,154,759
38,60,151,155,142,147,693
43,61,158,165,153,156,736
30,52,110,118,105,102,517
34,76,240,228,153,132,863
29,51,142,140,107,94,563
13,44,91,93,58,35,334
14,30,51,65,46,51,257
33,54,127,123,101,106,544
17,23,66,65,49,54,274
12,22,60,61,53,49,257
47,72,171,175,155,168,788
44,68,157,157,143,149,718
0,45,69,70,37,0,221
36,81,224,226,157,141,865
18,23,57,66,44,41,249
35,46,119,122,112,131,565
41,60,162,162,147,150,722
49,61,159,152,142,151,714
38,66,163,168,151,158,744
39,49,139,146,131,124,628
43,62,161,171,149,147,733
0,35,60,58,39,0,192
38,58,156,162,141,151,706
48,67,184,176,150,155,780
40,58,140,135,123,126,622
48,72,172,175,153,149,769
16,21,60,64,49,46,256
21,20,67,70,55,48,281
0,31,57,70,46,0,204
15,22,57,63,55,55,267
43,56,152,161,136,137,685
17,34,82,79,64,65,341
35,70,218,210,155,118,806
2,40,68,68,39,12,229
43,54,150,170,145,147,709
26,37,92,86,67,59,367
13,28,58,61,54,40,254
17,21,57,74,56,45,270
35,53,129,139,134,137,627
47,64,167,173,155,149,755
33,43,124,127,115,128,570
43,58,145,143,120,129,638
46,65,164,159,144,143,721
45,61,161,166,145,162,740
30,50,114,115,110,113,532
37,74,230,239,167,125,872
43,55,146,150,138,152,684
49,78,204,192,157,165,845
43,61,158,165,153,156,736
12,20,42,59,51,56,240
35,73,237,231,149,130,855
44,68,213,214,160,143,842
32,68,204,190,135,98,727
47,63,165,169,147,155,746
38,37,119,139,132,129,594
37,67,207,208,138,109,766
14,21,65,65,50,49,264
48,73,172,185,163,164,805
38,60,171,178,153,160,760
27,34,89,93,80,87,410
45,60,165,172,153,167,762
47,59,168,173,155,145,747
7,36,74,69,55,21,262
36,50,131,124,107,113,561
49,66,163,169,154,177,778
15,20,60,66,52,42,255
43,50,147,177,155,144,716
0,34,59,59,35,0,187
49,70,184,190,158,163,814
0,34,58,66,35,0,193
18,21,62,74,57,51,283
12,17,49,61,48,46,233
40,50,144,146,147,144,671
38,45,127,126,108,98,542
0,39,61,72,43,0,215
0,38,65,62,41,0,206
20,20,67,73,54,47,281
16,15,60,67,52,46,256
0,36,59,68,42,0,205
46,70,185,185,162,182,830
35,56,125,125,103,111,555
0,38,70,67,36,0,211
44,70,193,180,153,166,806
14,21,50,51,50,53,239
24,38,96,106,99,93,456
0,34,59,73,41,0,207
40,64,158,173,145,151,731
18,27,88,88,70,71,362
51,64,173,178,155,157,778
46,69,177,183,157,173,805
1,32,72,78,41,7,231
0,37,58,71,39,0,205
48,68,169,176,154,156,771
40,56,148,143,123,143,653
31,46,110,107,97,101,492
27,48,125,121,87,88,496
8,35,69,74,45,21,252
36,49,138,149,119,120,611
39,58,154,158,149,147,705
32,45,112,113,96,109,507
0,38,58,56,38,0,190
39,51,120,121,114,123,568
51,72,196,195,165,172,851
22,26,55,67,53,50,273
23,20,58,67,57,58,283
24,27,86,93,76,69,375
19,29,79,83,70,86,366
54,72,187,187,156,178,834
49,75,185,181,156,167,813
12,16,39,46,43,44,200
49,67,175,178,160,160,789
52,69,181,192,170,184,848
21,22,59,68,50,53,273
17,23,60,68,62,55,285
17,22,50,49,42,40,220
42,60,170,185,154,138,749
52,67,192,208,164,175,858
18,21,45,46,45,42,217
39,59,161,170,142,158,729
34,49,138,144,136,126,627
11,19,43,50,33,33,189
16,15,39,41,34,37,182
14,21,53,57,49,50,244
20,24,69,78,68,72,331
15,19,44,51,38,51,218
20,24,58,65,58,52,277
47,67,179,184,173,167,817
54,65,184,199,177,177,856
17,24,62,73,53,47,276
45,65,166,177,154,156,763
40,55,155,163,144,136,693
49,68,185,186,159,159,806
53,74,196,196,153,165,837
14,21,51,50,49,50,235
13,17,42,49,40,38,199
14,19,50,62,50,47,242
20,25,55,59,50,51,260
45,65,166,177,154,156,763
18,21,53,68,56,48,264
18,21,53,68,56,48,264
35,49,120,128,114,121,567
48,65,170,176,157,158,774
51,71,194,196,171,181,864
13,16,46,51,41,34,201
17,23,52,53,48,46,239
13,20,48,58,47,43,229
54,66,181,181,162,161,805
15,20,54,68,49,47,253
51,66,191,197,173,179,857
31,47,122,120,99,112,531
38,47,131,139,125,132,612
16,21,53,56,43,38,227
54,69,180,187,177,174,841
41,71,174,178,165,176,805
45,61,201,209,174,171,861
54,72,193,189,169,166,843
49,64,181,182,154,171,801
50,69,181,181,160,159,800
17,21,52,67,57,51,265
57,75,209,201,178,185,905
52,73,190,196,178,174,863
50,60,170,176,156,165,777
35,45,114,123,102,100,519
52,66,183,192,177,177,847
16,21,49,56,47,46,235
26,47,108,108,93,99,481
52,71,183,201,169,173,849
54,71,194,195,177,184,875
20,25,59,67,48,47,266
49,69,180,189,169,176,832
20,24,61,63,51,47,266
16,22,44,51,47,40,220
42,61,159,161,144,147,714
47,68,191,186,171,170,833
52,63,178,190,169,156,808
19,33,72,83,77,88,372
15,18,55,59,52,50,249
50,64,185,188,153,163,803
45,62,162,166,141,164,740
50,70,204,203,163,175,865
49,68,183,187,162,173,822
16,24,46,51,40,37,214
13,21,52,51,42,39,218
13,17,51,61,56,43,241
17,24,52,58,55,48,254
17,17,43,41,42,36,196
51,78,193,186,174,178,860
17,20,66,65,56,52,276
31,42,122,112,96,87,490
51,71,182,183,159,156,802
14,20,52,53,46,42,227
53,73,196,196,153,165,836
16,19,54,60,50,51,250
14,23,40,49,41,36,203
48,66,176,185,165,170,810
51,73,196,195,165,176,856
15,20,47,64,51,48,245
30,43,101,102,94,104,474
27,39,107,101,80,103,457
11,17,50,52,44,51,225
15,19,51,57,45,39,226
39,55,146,132,113,103,588
53,75,185,183,169,176,841
32,48,137,140,130,134,621
17,25,64,72,66,75,319
10,20,48,53,44,41,216
21,22,55,61,48,47,254
11,20,49,66,49,41,236
47,61,172,184,160,172,796
29,49,122,121,105,112,538
54,67,186,183,155,160,805
49,68,187,198,167,173,842
37,66,163,175,155,163,759
43,65,168,171,138,158,743
51,76,197,190,157,185,856
49,68,185,199,167,161,829
49,72,174,167,149,161,772
42,71,183,187,166,170,819
11,16,47,54,46,41,215
14,20,42,48,44,40,208
52,78,190,190,155,146,811
49,69,183,189,163,159,812
47,71,207,211,174,166,876
53,67,183,190,166,173,832
51,74,194,188,160,157,824
50,77,203,203,163,161,857
52,77,177,177,154,155,792
47,59,170,181,154,149,760
15,27,67,65,60,52,286
43,52,141,150,131,142,659
50,75,193,194,178,174,864
16,20,48,57,44,41,226
11,20,41,44,38,43,197
12,22,51,54,40,41,220
51,73,195,189,157,164,829
58,70,194,204,168,180,874
49,65,186,184,157,159,800
45,73,173,178,156,163,788
55,75,196,198,174,173,871
50,72,181,205,166,159,833
49,64,167,179,162,152,773
54,72,182,175,152,161,796
10,16,39,41,35,26,167
20,24,45,41,28,32,190
52,72,194,202,159,167,846
46,75,183,205,177,192,878
14,22,52,54,45,40,227
45,72,191,188,160,171,827
52,60,198,193,150,162,815
48,59,170,186,163,169,795
53,67,188,193,166,173,840
12,17,42,51,35,35,192
42,64,165,178,155,153,757
14,20,49,52,47,49,231
47,71,183,191,160,164,816
49,67,176,181,159,173,805
15,23,51,52,38,40,219
54,73,181,186,162,168,824
54,75,188,193,157,170,837
48,71,196,194,164,179,852
49,70,198,197,171,179,864
42,64,174,194,160,156,790
14,18,46,56,46,42,222
47,73,183,185,165,175,828
55,73,188,189,164,165,834
45,69,172,178,154,160,778
53,79,211,208,170,175,896
53,73,205,199,162,176,868
51,69,194,201,155,160,830
50,72,181,204,168,161,836
45,65,171,194,170,168,813
48,68,181,184,158,163,802
14,21,50,56,44,41,226
49,70,193,189,156,178,835
53,72,186,198,180,179,868
52,73,195,202,162,168,852
52,81,198,197,170,163,861
15,19,42,48,42,41,207
39,68,203,215,187,184,896
15,19,50,50,39,43,216
13,18,47,56,46,39,219
45,64,183,195,160,165,812
33,41,135,147,115,111,582
47,69,183,184,153,159,795
35,53,134,143,117,122,604
20,25,66,66,62,61,300
22,26,76,72,50,62,308
18,34,102,103,71,58,386
31,58,133,139,108,110,579
33,46,135,143,128,126,611
49,66,175,186,157,159,792
37,52,149,148,124,128,638
32,48,150,153,109,105,597
42,60,149,156,128,139,674
30,42,120,136,126,123,577
10,8,34,42,24,26,144
20,39,115,112,73,64,423
20,29,110,105,60,42,366
26,36,100,105,84,87,438
29,58,172,169,113,97,638
1,2,4,3,1,4,15
39,61,171,171,132,116,690
35,56,145,152,132,129,649
30,47,110,101,95,102,485
30,39,107,119,109,95,499
37,53,164,164,142,151,711
0,33,50,57,36,0,176
43,63,175,181,167,173,802
42,60,154,154,141,142,693
33,49,125,126,106,123,562
35,50,118,144,127,120,594
40,55,139,146,122,119,621
23,35,84,101,91,87,421
35,49,130,135,122,121,592
40,55,160,153,140,150,698
27,40,115,117,100,112,511
6,5,2,5,7,12,37
44,61,162,154,133,141,695
22,27,85,74,56,53,317
20,36,95,94,82,79,406
29,28,92,87,86,82,404
25,35,85,84,72,91,392
2,4,6,7,4,6,29
42,60,154,137,126,128,647
43,59,169,171,152,140,734
28,47,112,108,91,99,485
33,49,117,124,113,122,558
34,50,131,121,103,100,539
29,36,102,104,92,82,445
21,37,80,72,69,78,357
31,36,115,116,97,109,504
44,56,139,141,130,142,652
38,45,118,115,95,107,518
26,41,109,114,86,79,455
40,49,112,117,115,121,554
30,42,107,116,97,103,495
37,55,137,126,116,142,613
26,38,108,111,94,106,483
52,66,161,164,142,131,716
37,64,156,162,147,141,707
41,45,127,127,119,119,578
50,61,162,148,129,130,680
38,62,153,170,134,141,698
2,3,1,3,3,3,15
15,26,56,59,54,69,279
38,50,137,140,122,130,617
17,22,55,66,57,59,276
43,58,145,148,141,143,678
37,54,138,133,113,134,609
44,56,157,148,137,148,690
43,63,151,157,142,141,697
45,69,171,172,149,154,760
24,38,85,95,87,79,408
47,69,183,188,159,162,808
31,44,112,101,102,118,508
49,65,190,190,174,155,823
29,40,104,103,92,90,458
13,31,74,77,69,70,334
26,27,80,94,85,82,394
42,52,141,155,143,151,684
32,37,118,121,112,108,528
43,53,145,142,119,127,629
38,51,135,124,113,136,597
35,49,133,132,119,121,589
0,1,2,3,4,3,13
21,34,73,83,77,92,380
42,57,146,140,125,120,630
45,57,163,169,141,151,726
31,48,117,114,90,99,499
40,54,170,168,143,149,724
37,39,97,89,80,97,439
48,65,181,183,158,159,794
3,3,3,7,4,0,20
52,57,167,170,145,154,745
39,49,136,139,137,137,637
33,51,138,119,108,110,559
41,48,156,157,134,137,673
37,45,136,135,111,122,586
49,61,175,182,152,160,779
44,56,144,149,123,123,639
43,60,159,158,137,142,699
25,35,103,100,90,94,447
30,42,105,104,87,86,454
45,61,160,166,149,127,708
41,57,152,151,128,132,661
19,36,101,110,90,88,444
47,55,143,148,141,147,681
50,63,172,173,154,158,770
26,38,104,92,77,78,415
17,26,58,55,56,62,274
48,59,153,158,149,140,707
41,64,161,160,135,138,699
18,24,59,50,42,51,244
40,56,144,147,130,127,644
21,30,78,90,79,88,386
19,31,83,81,78,74,366
16,40,100,105,97,84,442
49,67,182,185,172,186,841
50,60,187,197,154,164,812
52,67,183,198,158,167,825
0,35,58,69,38,0,200
37,49,119,122,111,113,551
34,51,125,135,114,113,572
20,21,71,75,58,70,315
52,76,184,192,152,151,807
45,66,175,196,164,191,837
21,33,78,76,69,75,352
43,71,168,178,149,166,775
51,64,174,176,154,162,781
27,27,93,113,98,84,442
45,66,187,209,159,164,830
48,66,174,179,154,155,776
50,69,179,188,163,181,830
0,32,54,64,38,0,188
48,60,179,173,153,162,775
46,63,182,192,163,170,816
34,50,139,147,141,137,648
42,64,169,168,142,161,746
46,60,174,180,152,157,769
0,39,56,65,36,0,196
32,46,117,121,104,113,533
47,62,153,165,151,149,727
0,38,69,70,38,0,215
44,64,172,182,157,165,784
48,68,189,202,167,173,847
48,65,173,170,138,145,739
45,72,182,194,166,186,845
47,55,148,141,121,142,654
45,58,147,166,143,154,713
48,71,175,187,164,166,811
47,62,165,181,156,171,782
42,58,143,154,137,137,671
0,45,61,66,35,0,207
46,62,170,175,157,162,772
42,63,176,194,161,163,799
0,41,59,66,38,0,204
46,69,179,191,167,164,816
51,68,163,174,151,160,767
39,56,152,159,133,139,678
45,71,192,195,166,170,839
50,80,197,200,172,173,872
0,35,61,71,34,0,201
44,59,149,166,146,157,721
0,44,59,78,41,0,222
43,62,160,171,142,153,731
0,41,61,71,39,0,212
31,52,140,148,120,131,622
47,68,173,186,159,159,792
43,67,173,172,153,157,765
53,76,193,198,166,155,841
40,57,162,165,133,122,679
45,70,188,189,172,176,840
52,67,188,188,158,172,825
44,59,153,152,124,128,660
0,36,60,75,40,0,211
46,62,153,160,135,147,703
0,37,62,78,40,0,217
44,58,158,158,141,146,705
0,39,59,68,37,0,203
0,33,66,75,39,0,213
49,68,182,185,159,182,825
50,66,170,196,173,171,826
43,66,162,164,137,146,718
49,59,160,162,148,151,729
41,68,172,178,161,161,781
34,58,141,135,111,118,597
46,62,152,160,135,147,702
44,55,146,152,130,135,662
50,66,196,186,164,174,836
21,42,101,102,74,79,419
33,44,126,130,126,125,584
49,61,154,160,146,142,712
50,65,172,166,149,139,741
46,72,175,185,162,174,814
56,130,288,308,238,269,1289
36,55,144,150,119,131,635
35,49,144,141,133,132,634
33,51,141,130,103,116,574
15,13,68,69,60,61,286
46,69,175,169,150,159,768
14,24,64,68,63,61,294
14,31,80,84,67,61,337
32,46,108,107,95,93,481
43,49,160,161,141,141,695
37,41,146,145,130,137,636
37,49,132,137,106,122,583
49,63,170,175,154,165,776
51,65,176,170,152,160,774
41,62,150,142,119,143,657
36,48,119,112,108,110,533
36,55,141,143,119,131,625
38,62,146,141,124,137,648
34,48,134,140,123,133,612
23,30,103,102,83,99,440
42,51,134,137,120,132,616
29,44,122,137,118,128,578
43,49,126,131,122,115,586
37,57,142,139,122,137,634
43,54,154,159,132,128,670
34,41,132,120,110,124,561
20,25,58,61,56,54,274
43,54,145,137,123,134,636
36,49,124,129,116,108,562
28,40,102,96,87,95,448
47,64,175,178,148,138,750
25,40,101,98,85,89,438
47,61,162,157,142,144,713
43,62,171,167,134,152,729
42,56,140,142,121,132,633
31,47,116,113,92,104,503
26,34,88,95,82,96,421
27,35,94,102,100,98,456
21,35,103,94,76,102,431
21,30,92,92,78,72,385
20,21,80,91,78,78,368
24,34,90,85,76,85,394
24,34,90,85,76,85,394
26,32,80,86,83,86,393
18,26,62,69,57,61,293
20,23,66,75,69,64,317
1,2,5,3,2,2,15
17,24,68,76,63,64,312
16,23,70,64,48,47,268
38,53,142,150,123,131,637
1,3,4,5,6,3,22
25,46,111,117,105,106,510
31,37,99,77,63,92,399
36,36,90,86,82,98,428
34,41,94,77,73,88,407
20,25,67,71,53,53,289
39,42,137,144,129,141,632
20,33,83,100,94,99,429
36,53,128,128,122,129,596
31,47,121,105,92,94,490
17,24,61,63,52,38,255
32,47,124,125,94,101,523
19,28,70,65,66,55,303
1,1,3,3,0,4,12
12,14,41,57,52,41,217
21,20,54,65,57,64,281
53,62,179,178,144,150,766
42,62,179,179,152,175,789
36,50,154,158,148,152,698
17,29,83,80,60,79,348
16,22,71,61,49,58,277
16,22,71,61,49,58,277
48,63,182,187,164,177,821
45,65,172,181,148,155,766
48,70,192,185,149,157,801
51,72,189,193,163,156,824
40,60,164,166,154,175,759
45,58,177,178,150,155,763
47,64,173,171,156,166,777
47,63,179,172,156,168,785
46,61,184,186,160,158,795
39,48,126,133,101,88,535
42,60,168,174,154,160,758
30,42,130,142,118,109,571
33,51,133,133,114,112,576
36,54,150,152,122,142,656
21,22,68,79,70,59,319
37,57,139,147,117,138,635
42,58,155,151,132,156,694
32,38,109,115,101,84,479
28,41,114,119,102,110,514
33,50,116,122,115,115,551
33,50,116,121,114,115,549
38,51,133,139,121,123,605
40,49,140,147,134,137,647
26,29,98,95,75,89,412
22,38,84,85,73,63,365
42,52,134,144,135,133,640
42,53,149,149,134,143,670
37,59,153,160,133,145,687
41,57,157,145,124,123,647
50,65,190,193,169,167,834
44,62,182,193,156,149,786
29,39,94,95,91,94,442
25,30,99,100,89,90,433
45,67,168,169,150,152,751
46,64,171,190,163,169,803
28,37,88,85,77,91,406
29,44,117,129,113,110,542
28,41,105,123,100,93,490
30,40,110,107,87,102,476
48,69,191,196,163,165,832
44,58,151,150,133,142,678
43,57,153,159,135,152,699
38,63,166,182,152,161,762
30,41,104,108,105,107,495
36,52,139,140,106,105,578
43,57,148,149,136,150,683
41,51,141,150,128,133,644
23,31,72,76,83,95,380
34,48,122,128,108,117,557
24,39,97,89,75,82,406
41,51,136,138,115,130,611
41,58,137,139,126,122,623
41,53,147,153,132,136,662
43,55,170,172,146,166,752
41,57,161,174,130,141,704
46,62,176,180,154,167,785
49,67,189,188,157,167,817
42,62,179,198,164,157,802
50,67,188,193,166,173,837
38,49,148,142,104,106,587
54,70,182,189,159,153,807
49,64,184,181,163,168,809
42,60,165,163,148,155,733
48,66,169,165,144,158,750
40,61,150,150,141,141,683
42,70,166,180,160,180,798
43,61,163,167,150,160,744
42,63,145,149,131,141,671
48,67,173,186,163,166,803
46,70,172,169,153,153,763
35,55,142,148,135,138,653
58,73,184,186,165,193,859
52,73,186,187,153,159,810
42,59,154,161,143,139,698
47,62,160,163,135,151,718
35,52,128,135,113,123,586
34,55,145,141,120,114,609
34,48,127,132,114,101,556
44,62,175,168,157,160,766
45,64,170,166,146,167,758
41,63,177,184,159,162,786
37,56,140,147,128,125,633
31,44,118,123,103,100,519
54,67,194,183,162,168,828
51,71,190,182,158,161,813
49,68,184,191,158,168,818
44,62,166,175,157,151,755
44,62,166,175,157,151,755
45,61,166,162,143,146,723
42,58,191,201,166,159,817
45,67,179,176,157,169,793
46,64,176,182,160,169,797
51,67,180,176,143,157,774
56,69,202,184,160,168,839
54,67,194,177,163,179,834
31,43,117,125,107,103,526
51,72,181,182,164,174,824
31,41,109,114,89,89,473
51,71,186,190,167,182,847
50,70,184,177,145,161,787
45,70,181,175,149,153,773
48,73,190,185,163,165,824
39,60,147,153,129,129,657
46,67,178,179,155,171,796
48,69,186,199,173,163,838
53,73,190,180,159,157,812
49,75,186,183,181,172,846
42,60,172,185,157,172,788
20,26,71,61,55,66,299
45,57,161,186,161,150,760
43,61,167,186,173,173,803
52,71,186,192,177,177,855
52,66,192,193,156,159,818
46,64,183,206,178,161,838
52,71,190,186,171,163,833
46,62,161,152,145,158,724
42,60,157,157,146,161,723
46,64,173,176,143,172,774
51,65,198,191,161,157,823
42,63,166,168,148,148,735
45,62,172,181,159,155,774
42,55,164,164,147,159,731
48,64,178,182,150,145,767
47,62,183,182,167,178,819
39,56,130,136,118,127,606
38,67,171,175,151,159,761
43,63,169,177,148,141,741
41,66,160,161,149,153,730
47,71,172,173,149,159,771
30,54,143,154,127,129,637
35,51,134,128,104,128,580
13,25,65,58,52,64,277
51,73,192,191,170,164,841
419,1051,2119,2127,1660,2081,9457
34,45,124,127,118,123,571
35,50,125,123,112,115,560
50,61,182,176,144,150,763
43,56,157,159,137,144,696
37,61,140,144,124,119,625
40,60,148,147,125,125,645
40,55,147,165,148,146,701
42,66,157,164,142,133,704
41,56,155,168,139,127,686
36,58,138,156,142,148,678
41,55,138,163,145,143,685
41,54,139,159,137,150,680
48,58,163,161,140,154,724
19,24,58,79,67,68,315
27,36,102,104,94,116,479
26,37,90,102,92,112,459
35,43,119,113,95,108,513
28,45,120,136,104,98,531
31,45,119,119,114,120,548
34,49,125,129,119,121,577
27,39,103,100,91,104,464
47,76,182,175,151,171,802
52,69,185,179,170,187,842
47,63,169,170,157,158,764
37,56,146,150,134,126,649
43,70,163,158,143,151,728
43,67,168,167,146,149,740
30,40,110,116,95,96,487
20,45,101,98,89,100,453
44,66,191,178,153,165,797
50,63,195,192,154,153,807
45,63,183,186,154,152,783
21,36,73,69,64,63,326
46,73,205,193,168,177,862
48,72,194,201,156,142,813
41,69,170,191,167,163,801
52,70,183,185,155,167,812
50,62,186,204,174,164,840
50,62,196,194,177,175,854
45,69,179,169,155,164,781
42,64,178,181,150,148,763
42,60,168,180,155,159,764
488,1308,2639,2678,2152,2570,11835
354,787,1652,1637,1293,1595,7318
47,65,168,174,161,156,771
0,41,55,63,41,0,200
38,52,136,141,121,129,617
0,37,60,53,33,0,183
0,36,56,55,34,0,181
0,38,60,62,35,0,195
0,33,59,59,38,0,189
46,62,177,180,157,153,775
35,57,150,154,128,130,654
50,68,192,190,161,171,832
49,60,176,186,163,169,803
40,61,152,156,129,129,667
43,64,181,172,157,166,783
0,39,58,59,33,0,189
47,64,160,172,147,163,753
45,67,155,161,147,151,726
44,58,153,155,131,129,670
47,62,165,159,128,131,692
54,72,185,193,168,172,844
49,64,177,191,164,160,805
51,64,165,168,150,143,741
43,65,166,177,152,167,770
46,62,152,152,145,147,704
47,62,161,172,144,154,740
45,59,141,145,128,142,660
39,57,142,140,124,131,633
45,57,154,165,137,151,709
41,60,164,177,149,141,732
45,66,172,180,150,169,782
45,61,158,166,148,151,729
43,63,167,166,137,143,719
55,75,180,179,162,159,810
48,71,173,188,163,162,805
45,66,172,178,157,175,793
51,67,183,190,155,172,818
50,68,182,190,154,170,814
50,72,180,193,164,164,823
51,76,184,195,166,165,837
45,73,185,185,163,167,818
54,67,184,188,162,173,828
44,64,176,188,168,168,808
49,73,188,180,156,164,810
0,37,63,60,30,0,190
0,37,63,60,30,0,190
0,36,63,89,43,0,231
46,64,181,193,170,167,821
42,67,179,185,174,168,815
54,71,193,196,158,168,840
44,73,186,190,160,160,813
54,72,181,182,155,164,808
47,60,184,183,151,151,776
49,65,186,182,151,165,798
45,57,145,136,120,126,629
49,57,158,161,137,152,714
49,54,151,170,148,144,716
52,67,171,175,157,171,793
52,67,171,175,157,171,793
48,60,168,189,166,165,796
50,69,188,181,153,181,822
49,65,195,198,160,177,844
53,62,178,186,162,169,810
46,69,182,172,148,163,780
51,72,184,183,148,162,800
44,61,154,157,131,158,705
49,72,176,187,160,170,814
50,64,178,195,163,179,829
46,65,157,174,150,159,751
47,66,172,181,156,169,791
28,32,84,93,72,81,390
35,46,123,148,135,124,611
43,64,162,168,136,151,724
40,50,140,141,113,122,606
37,58,139,136,107,117,594
39,56,152,153,135,128,663
51,79,194,189,146,163,822
49,73,179,183,150,166,800
45,62,164,168,142,169,750
50,59,162,165,150,156,742
51,67,187,195,159,156,815
53,74,205,203,150,155,840
52,62,184,194,154,157,803
32,52,126,132,117,111,570
25,48,124,132,107,124,560
49,67,196,187,154,173,826
38,51,138,142,117,117,603
40,49,137,138,124,124,612
40,54,121,114,113,126,568
0,41,66,69,31,0,207
0,38,54,78,33,0,203
50,71,184,192,153,166,816
49,75,188,196,157,171,836
49,71,183,195,157,170,825
53,60,192,195,154,170,824
53,60,192,195,154,170,824
47,61,193,202,157,167,827
52,64,181,185,152,165,799
50,74,184,190,166,175,839
49,67,195,196,153,155,815
19,41,103,102,69,78,412
48,75,196,188,170,188,865
36,61,157,175,146,152,727
50,75,200,203,160,169,857
25,37,92,92,86,93,425
0,31,55,66,34,0,186
0,33,53,65,30,0,181
51,72,178,182,165,170,818
0,38,58,68,35,0,199
0,38,66,79,44,0,227
32,48,123,138,122,123,586
16,36,71,84,56,47,310
20,38,75,90,66,64,353
41,61,150,163,139,155,709
0,35,55,75,43,0,208
0,39,69,82,39,0,229
48,66,184,191,165,156,810
57,69,195,183,155,166,825
23,33,67,65,69,58,315
45,61,161,160,139,151,717
45,75,177,181,154,167,799
0,34,60,65,36,0,195
0,34,67,69,39,0,209
0,37,57,64,36,0,194
0,38,70,68,42,0,218
0,42,71,71,37,0,221
0,37,64,76,37,0,214
52,71,189,193,167,176,848
0,38,55,61,35,0,189
51,66,192,206,184,172,871
48,74,193,187,167,167,836
37,63,161,165,140,160,726
44,59,167,170,135,144,719
0,34,57,69,33,0,193
46,66,176,191,159,176,814
37,49,129,135,119,106,575
47,68,174,186,164,169,808
44,65,190,188,163,166,816
18,21,67,80,63,45,294
47,76,182,189,169,180,843
50,63,181,177,152,163,786
46,56,158,158,142,154,714
44,70,172,179,148,154,767
33,48,124,124,89,102,520
30,39,106,111,77,87,450
44,59,153,167,148,141,712
50,66,165,170,152,160,763
35,49,114,112,108,123,541
16,21,61,56,46,43,243
28,37,100,77,65,77,384
25,34,87,90,75,90,401
13,16,51,55,51,48,234
0,34,64,66,45,0,209
17,17,52,63,50,45,244
46,63,155,150,122,135,671
27,29,75,69,82,100,382
43,57,142,137,121,139,639
44,67,177,168,151,151,758
0,30,69,72,38,6,215
50,73,219,215,169,165,891
22,46,110,125,88,65,456
2,42,67,66,34,7,218
51,68,171,176,159,161,786
46,68,190,193,160,167,824
0,33,59,62,42,0,196
17,20,65,64,54,54,274
28,50,109,111,93,99,490
42,57,150,147,127,139,662
26,37,90,90,70,65,378
0,29,52,53,34,2,170
50,73,196,204,171,176,870
53,68,188,182,171,177,839
51,73,196,198,167,176,861
23,25,56,67,53,52,276
15,25,54,46,48,59,247
10,21,48,47,31,25,182
13,20,39,52,47,34,205
46,75,193,212,165,158,849
41,62,161,167,155,157,743
19,17,67,58,43,51,255
19,25,61,62,47,48,262
48,71,179,188,173,173,832
32,45,125,119,108,109,538
48,72,187,190,166,164,827
55,75,193,205,173,166,867
18,22,67,57,48,48,260
7,4,7,4,4,6,32
24,36,102,116,96,117,491
27,40,99,97,86,101,450
50,66,189,191,171,170,837
53,65,194,206,165,170,853
51,67,182,188,171,147,806
47,63,174,191,162,166,803
43,62,164,174,155,165,763
15,22,48,57,42,41,225
51,71,182,195,168,174,841
46,65,177,187,159,167,801
54,72,195,195,169,173,858
44,66,191,202,166,190,859
50,69,183,192,179,166,839
52,72,189,189,167,178,847
51,73,196,198,163,161,842
13,20,47,59,45,39,223
46,69,185,189,161,181,831
38,65,153,160,138,135,689
39,62,161,170,147,147,726
44,73,183,191,167,163,821
40,64,168,173,143,156,744
14,16,48,49,40,36,203
57,74,195,198,163,154,841
13,18,49,54,42,41,217
57,65,200,198,167,152,839
46,61,190,202,164,155,818
45,70,174,196,171,176,832
48,75,190,194,176,172,855
10,15,35,45,38,38,181
46,68,182,196,164,181,837
10,14,45,48,40,34,191
10,18,46,54,45,40,213
11,16,39,46,38,43,193
14,14,41,48,44,38,199
15,20,49,58,42,37,221
36,53,117,122,115,120,563
52,78,186,198,185,174,873
33,46,125,131,119,126,580
45,61,167,186,155,161,775
53,66,188,192,157,161,817
49,70,191,208,170,175,863
48,69,193,189,157,175,831
52,70,192,208,164,168,854
47,75,183,205,177,192,879
31,40,94,94,83,83,425
11,16,32,45,35,28,167
44,71,176,207,173,154,825
45,73,183,193,173,172,839
49,72,184,191,164,168,828
44,67,175,191,169,164,810
48,71,169,185,158,161,792
45,65,179,187,149,161,786
11,19,33,48,36,36,183
13,21,51,54,38,36,213
43,67,179,193,167,167,816
12,20,46,42,32,33,185
37,55,149,144,115,128,628
15,16,49,57,42,41,220
18,18,50,56,44,42,228
51,72,185,204,178,171,861
29,39,102,103,95,82,450
52,68,183,185,163,172,823
47,63,171,183,149,163,776
45,62,178,177,141,141,744
42,68,177,167,153,169,776
42,66,170,166,157,153,754
43,66,171,173,153,151,757
28,37,104,115,100,99,483
38,54,127,130,115,107,571
43,54,153,153,136,145,684
40,64,182,173,152,149,760
9,22,54,55,41,40,221
17,35,79,85,74,85,375
14,20,63,68,58,59,282
15,40,111,112,67,60,405
21,34,107,110,69,63,404
45,67,179,186,162,155,794
42,60,161,161,138,141,703
37,55,152,166,152,149,711
9,15,33,33,23,30,143
20,37,114,101,67,56,395
18,18,56,62,47,43,244
25,51,169,176,114,86,621
15,27,79,90,81,81,373
6,7,17,12,8,19,69
26,34,93,102,94,88,437
44,55,139,160,139,124,661
5,4,2,6,4,2,23
49,55,153,168,141,144,710
1,1,3,3,3,4,15
32,52,129,125,95,98,531
0,5,8,4,1,0,18
0,26,39,43,29,0,137
0,29,48,53,33,0,163
30,42,129,141,119,109,570
39,63,156,157,141,161,717
26,38,99,112,95,99,469
23,50,107,110,102,99,491
44,65,171,170,152,144,746
22,26,78,82,56,59,323
25,34,93,101,93,89,435
41,52,153,156,130,130,662
48,74,192,203,177,184,878
14,17,47,53,44,38,213
12,17,59,65,61,69,283
23,41,79,81,83,87,394
49,60,149,157,142,155,712
44,60,173,167,147,152,743
28,42,110,116,111,115,522
39,57,133,140,126,131,626
47,67,162,165,156,156,753
47,72,181,195,161,175,831
34,53,136,145,126,135,629
39,49,140,172,143,145,688
35,49,127,125,108,112,556
31,42,110,114,102,108,507
44,60,161,167,143,143,718
46,61,163,169,149,154,742
47,68,171,179,161,158,784
41,53,156,151,133,136,670
42,62,159,174,147,143,727
46,71,181,170,149,161,778
47,69,172,168,162,175,793
44,68,179,184,159,178,812
48,68,177,181,157,169,800
42,58,159,161,133,145,698
34,54,124,140,114,121,587
43,56,155,157,134,147,692
42,49,151,156,131,136,665
31,36,111,108,93,108,487
42,57,165,162,133,139,698
0,37,68,77,35,0,217
0,41,64,78,37,0,220
0,30,57,74,38,0,199
45,67,172,189,170,162,805
0,35,67,74,39,0,215
0,40,64,77,34,0,215
44,66,178,180,156,183,807
45,69,176,179,157,165,791
11,28,72,76,53,35,275
13,37,84,90,61,49,334
45,65,169,178,161,156,774
30,40,110,118,99,96,493
52,72,193,202,183,186,888
32,44,116,128,117,133,570
17,17,65,73,57,46,275
14,42,120,120,80,45,421
18,21,64,64,54,55,276
21,24,56,66,52,50,269
0,35,56,61,39,0,191
16,22,57,62,43,47,247
18,18,51,59,54,47,247
44,50,143,147,135,149,668
20,29,90,84,62,53,338
12,22,51,53,41,32,211
48,64,181,187,175,170,825
32,51,149,149,126,126,633
10,21,53,60,45,52,241
30,32,100,95,82,76,415
5,7,16,17,16,14,75
36,53,131,117,107,120,564
17,24,71,63,53,64,292
49,66,185,178,153,163,794
40,52,147,154,139,142,674
30,45,102,100,90,79,446
44,51,147,146,133,142,663
25,35,83,106,99,99,447
54,63,181,185,163,159,805
16,28,75,92,77,73,361
40,59,159,161,134,141,694
45,60,149,155,139,154,702
45,54,157,171,143,146,716
42,62,159,178,147,143,731
27,32,97,116,101,100,473
42,61,159,164,135,141,702
27,28,91,102,101,96,445
26,37,102,120,105,114,504
23,40,107,106,91,104,471
43,55,166,164,147,154,729
46,67,188,205,170,183,859
49,64,168,177,162,169,789
45,54,147,150,134,144,674
48,66,201,199,182,179,875
47,60,181,195,168,165,816
52,66,194,189,153,169,823
51,68,183,185,157,165,809
45,64,157,168,155,169,758
47,66,166,176,152,165,772
42,54,143,148,124,134,645
45,58,144,156,137,143,683
47,67,194,201,156,157,822
47,73,181,184,153,171,809
0,38,72,69,45,0,224
17,44,131,120,75,65,452
33,53,157,163,131,131,668
41,52,141,150,118,123,625
41,52,141,150,118,123,625
14,24,60,57,49,54,258
41,67,180,183,158,170,799
26,31,100,111,73,83,424
36,51,131,133,114,111,576
0,35,66,63,41,0,205
49,66,185,187,163,168,818
38,59,149,161,152,147,706
52,68,187,189,167,175,838
50,72,178,184,178,177,839
44,69,186,203,160,167,829
50,68,180,192,170,173,833
49,66,186,175,150,163,789
27,40,82,79,64,66,358
13,25,65,58,36,51,248
23,37,84,79,72,65,360
46,70,163,171,155,159,764
24,42,121,126,110,102,525
18,26,62,71,64,71,312
22,30,72,71,65,67,327
17,24,77,83,78,78,357
46,68,189,179,154,164,800
47,58,167,178,147,162,759
48,64,183,168,151,164,778
30,31,75,82,80,75,373
40,58,164,160,132,153,707
43,63,169,178,156,159,768
52,68,175,194,169,166,824
41,53,156,151,133,136,670
30,48,124,121,99,91,513
31,38,107,106,105,115,502
36,50,154,160,143,143,686
45,55,160,165,144,141,710
43,67,175,176,151,165,777
18,16,48,56,53,46,237
18,23,51,54,46,40,232
32,45,126,128,109,111,551
51,65,166,166,142,156,746
42,63,178,185,163,166,797
40,44,139,137,111,124,595
39,51,130,138,122,122,602
39,52,146,157,136,138,668
39,51,139,145,125,134,633
39,63,154,155,132,134,677
22,30,63,63,49,48,275
37,50,140,142,106,119,594
36,48,139,132,119,134,608
13,21,58,67,52,56,267
34,54,132,151,149,144,664
1,2,6,5,6,4,24
40,67,167,174,154,160,762
12,21,40,48,41,35,197
40,53,133,137,122,114,599
39,50,137,128,110,111,575
34,49,140,128,102,113,566
33,56,142,154,139,136,660
33,55,141,154,139,136,658
25,29,80,81,63,63,341
35,60,147,154,133,139,668
35,50,122,126,123,132,588
41,44,145,141,116,130,617
28,40,113,123,116,127,547
28,39,122,128,113,101,531
22,30,91,85,70,65,363
44,61,166,169,151,152,743
39,52,137,149,141,142,660
16,25,53,60,48,35,237
17,25,53,63,59,69,286
20,24,73,82,73,59,331
30,31,92,93,84,93,423
53,67,181,176,157,169,803
47,66,185,188,152,153,791
47,64,175,176,139,143,744
37,52,141,140,122,117,609
14,31,87,94,65,46,337
44,54,156,155,140,149,698
40,47,148,156,140,157,688
30,39,102,107,85,90,453
38,51,125,130,122,118,584
46,64,180,185,158,155,788
19,30,91,90,66,61,357
24,32,95,103,79,72,405
20,36,88,88,90,82,404
5,4,5,5,3,5,27
40,53,149,146,138,147,673
32,40,103,94,89,98,456
26,39,105,101,90,107,468
32,40,107,113,93,96,481
2,2,1,6,6,5,22
3,5,13,14,11,12,58
39,51,132,133,119,120,594
2,3,2,1,1,1,10
50,59,186,181,162,152,790
44,59,160,167,152,161,743
11,17,41,48,41,32,190
5,3,5,2,4,8,27
5,6,8,10,12,4,45
4,4,2,6,4,6,26
25,41,98,91,68,92,415
43,56,154,150,131,149,683
20,22,61,81,78,74,336
13,22,67,65,59,68,294
26,33,90,96,89,95,429
44,67,176,168,150,150,755
35,49,131,138,120,108,581
43,70,195,191,169,158,826
20,30,78,80,74,74,356
15,32,76,78,67,75,343
20,26,68,79,60,78,331
12,22,51,53,41,32,211
26,39,92,90,79,73,399
13,15,60,60,34,31,213
30,47,121,112,87,87,484
2,2,3,3,4,10,24
20,29,75,82,65,73,344
5,5,2,9,5,2,28
28,37,81,77,84,94,401
28,45,105,99,85,89,451
18,30,85,94,87,87,401
14,25,80,80,61,72,332
23,37,96,110,90,97,453
37,55,136,134,124,142,628
6,3,2,4,5,6,26
16,20,48,61,58,46,249
7,7,15,14,7,15,65
35,51,136,144,120,128,614
46,66,178,177,160,167,794
41,53,149,155,135,129,662
54,62,167,171,161,161,776
26,32,84,87,79,76,384
51,70,187,195,150,160,813
50,70,185,190,167,171,833
50,74,187,202,174,166,853
54,71,189,187,167,144,812
15,39,116,119,87,58,434
13,19,66,58,52,49,257
52,75,186,178,161,164,816
36,60,148,150,138,145,677
