52,80,189,190,155,171,837
15,23,58,67,67,84,314
5,14,27,31,20,24,121
19,32,89,83,65,58,346
55,76,204,199,165,170,869
12,18,39,37,28,34,168
36,53,154,161,132,142,678
19,21,61,74,68,74,317
23,18,55,76,66,63,301
50,67,187,185,153,183,825
23,28,84,98,71,84,388
15,30,75,67,53,53,293
20,27,72,79,76,78,352
20,30,85,85,68,70,358
3,9,12,23,27,21,95
15,18,54,53,50,56,246
13,22,41,44,34,36,190
25,36,78,80,61,65,345
11,16,57,62,43,52,241
20,21,60,53,45,52,251
22,24,59,59,63,66,293
21,20,66,70,57,69,303
39,53,139,146,124,118,619
29,34,85,88,69,78,383
48,76,184,190,169,172,839
22,27,82,92,81,68,372
23,35,91,97,90,90,426
17,38,89,96,83,81,404
50,68,182,185,156,156,797
12,23,37,46,41,40,199
19,22,58,55,52,59,265
51,65,160,156,154,169,755
21,36,94,104,88,100,443
30,42,96,92,83,82,425
46,71,196,193,159,178,843
35,54,138,138,135,139,639
14,31,92,91,56,47,331
23,18,55,56,53,61,266
17,41,117,114,83,64,436
21,46,116,109,83,70,445
42,54,148,154,122,142,662
40,56,147,154,137,136,670
48,65,191,196,164,172,836
47,65,163,176,145,151,747
23,56,125,99,71,63,437
18,32,90,101,77,86,404
21,23,72,91,70,78,355
27,42,109,116,92,95,481
43,59,162,170,144,134,712
6,8,15,20,18,13,80
29,33,97,84,60,52,355
6,12,21,18,15,18,90
40,56,152,157,129,128,662
22,21,70,78,72,80,343
20,29,67,58,57,75,306
20,27,72,75,73,67,334
22,35,83,88,73,66,367
8,7,6,4,3,2,30
18,28,105,102,70,58,381
10,17,42,35,26,28,158
26,36,97,77,67,76,379
21,35,81,83,67,58,345
19,36,75,73,80,86,369
41,50,126,137,129,132,615
14,48,126,120,74,57,439
16,21,67,68,66,57,295
13,32,73,70,43,58,289
20,26,59,62,52,56,275
47,69,195,191,168,163,833
25,37,93,95,86,79,415
30,42,112,119,96,93,492
45,51,156,168,139,155,714
46,58,169,191,164,163,791
46,72,187,198,183,174,860
29,33,83,87,79,68,379
7,12,34,42,38,41,174
26,34,110,122,109,100,501
21,38,84,83,79,92,397
32,49,131,128,114,119,573
19,39,92,98,99,89,436
23,50,117,109,87,63,449
34,52,150,160,133,140,669
41,58,155,154,129,129,666
27,35,84,84,68,71,369
45,64,164,162,150,148,733
15,31,93,98,71,60,368
21,53,127,121,71,62,455
18,48,118,112,74,61,431
38,57,157,161,136,147,696
20,23,62,59,41,51,256
24,35,98,118,96,94,465
23,29,87,83,68,75,365
33,43,126,146,117,127,592
31,46,107,107,94,102,487
45,67,150,160,140,148,710
54,75,188,183,177,177,854
19,26,84,98,88,68,383
14,30,70,73,54,40,281
8,10,22,22,15,18,95
30,37,98,101,103,106,475
44,61,178,180,153,157,773
28,43,95,108,88,94,456
56,68,188,174,161,173,820
26,42,105,109,81,93,456
21,29,95,98,80,90,413
42,61,163,181,147,157,751
9,22,53,44,41,43,212
16,36,108,105,60,46,371
11,12,28,32,26,28,137
34,34,93,115,107,90,473
11,34,100,91,67,56,359
41,53,143,164,146,152,699
21,29,79,93,73,68,363
22,48,138,129,83,65,485
27,35,110,122,108,95,497
11,42,126,117,71,61,428
22,32,78,87,89,95,403
24,31,96,107,95,99,452
19,42,88,97,100,89,435
41,56,172,180,153,158,760
12,25,66,62,60,57,282
23,43,143,132,105,87,533
9,16,53,58,42,36,214
18,25,66,60,54,58,281
37,55,139,138,117,138,624
52,75,189,187,163,165,831
39,62,153,149,140,134,677
34,40,108,120,106,99,507
47,65,173,184,163,167,799
17,49,135,133,87,64,485
10,20,69,66,41,32,238
19,48,116,111,70,54,418
16,37,106,105,74,61,399
35,53,137,147,118,114,604
26,32,89,102,97,70,416
42,67,156,148,129,129,671
44,62,180,171,155,170,782
14,37,79,77,63,62,332
22,51,157,158,108,88,584
13,20,43,52,50,44,222
52,66,174,194,158,142,786
15,30,80,81,69,65,340
8,14,26,38,35,38,159
7,17,36,46,31,24,161
18,23,57,51,36,52,237
14,20,62,71,56,49,272
29,41,99,82,66,76,393
27,40,109,102,85,94,457
24,38,84,79,76,75,376
45,64,178,184,157,154,782
25,36,95,103,89,97,445
45,62,152,149,128,128,664
13,37,103,104,74,65,396
26,38,93,91,87,84,419
17,28,56,58,58,52,269
28,45,100,109,107,96,485
54,73,189,175,168,163,822
36,54,130,142,124,127,613
18,37,103,102,68,64,392
21,27,76,75,52,56,307
15,23,65,74,56,69,302
41,60,166,174,147,147,735
15,36,127,122,76,69,445
20,50,132,136,92,67,497
17,32,86,98,80,74,387
19,16,45,50,40,27,197
5,4,9,6,7,6,37
26,33,93,105,86,82,425
26,35,88,84,78,89,400
41,67,168,191,158,163,788
18,28,59,51,43,61,260
10,26,87,100,60,32,315
40,63,174,177,148,158,760
5,6,9,10,10,7,47
17,21,57,49,41,55,240
37,51,148,160,145,144,685
15,28,67,76,67,67,320
20,34,81,82,67,78,362
40,53,164,163,140,138,698
18,26,63,57,39,40,243
37,52,125,124,108,119,565
21,26,83,83,67,80,360
5,5,11,10,7,10,48
23,49,125,121,90,79,487
14,25,63,53,49,58,262
24,24,86,97,67,83,381
47,69,186,192,152,163,809
48,69,184,174,162,154,791
41,55,165,176,146,130,713
5,4,5,8,7,5,34
14,13,40,63,61,46,237
28,40,98,105,91,105,467
21,24,53,51,49,33,231
52,65,186,184,168,161,816
29,34,105,96,75,87,426
20,27,72,89,69,83,360
22,51,141,132,83,71,500
21,53,128,122,71,63,458
21,57,129,108,78,57,450
19,51,141,147,98,81,537
7,13,20,31,21,13,105
11,17,42,51,35,34,190
28,35,92,116,99,92,462
19,32,83,68,66,91,359
8,9,10,17,23,33,100
3,13,24,24,15,20,99
24,53,141,138,97,78,531
24,30,84,83,86,84,391
15,17,54,53,42,52,233
41,56,154,165,135,144,695
40,53,151,149,127,144,664
17,27,72,76,65,63,320
15,42,97,82,63,64,363
30,40,88,92,85,91,426
26,49,142,138,101,76,532
20,49,131,125,82,65,472
18,20,51,63,58,68,278
46,61,180,200,167,162,816
20,32,69,61,48,54,284
44,60,171,193,173,181,822
40,62,175,188,154,159,778
29,36,100,85,81,95,426
22,20,77,103,109,100,431
14,39,109,103,67,52,384
39,41,102,105,95,103,485
20,32,104,105,87,95,443
25,31,97,111,83,79,426
34,43,114,125,107,114,537
7,16,31,37,25,35,151
20,28,70,78,67,62,325
19,14,57,72,66,56,284
19,19,53,62,48,43,244
25,38,91,89,74,86,403
22,33,92,104,94,86,431
7,15,21,18,24,25,110
34,42,132,130,109,126,573
49,71,184,187,165,161,817
51,73,180,183,162,167,816
50,61,152,160,129,140,692
14,39,106,112,80,59,410
11,24,41,38,35,35,184
6,9,23,16,18,18,90
21,24,72,77,68,72,334
16,33,97,91,60,44,341
20,34,82,89,86,90,401
19,33,105,105,70,58,390
15,18,61,66,53,52,265
22,33,80,84,81,86,386
25,31,90,109,86,70,411
8,13,23,22,19,16,101
38,52,124,131,111,122,578
41,57,148,154,131,131,662
19,45,119,109,80,52,424
54,66,182,170,153,173,798
13,20,42,48,35,37,195
26,37,98,95,77,92,425
32,36,92,96,99,103,458
5,2,6,7,6,5,31
18,42,131,111,74,61,437
37,46,113,115,100,94,505
6,13,21,19,16,18,93
27,44,109,121,96,93,490
48,67,187,185,162,168,817
15,34,90,99,64,50,352
30,38,107,113,103,97,488
30,45,107,107,95,103,487
26,34,96,103,88,73,420
31,45,109,107,97,114,503
37,53,135,146,117,124,612
20,51,142,147,98,71,529
30,36,110,111,88,98,473
48,64,185,181,154,161,793
49,60,168,168,155,156,756
39,55,139,135,122,125,615
26,42,100,94,100,111,473
3,3,9,10,13,13,51
26,45,152,150,107,92,572
18,58,142,143,91,72,524
28,34,105,116,102,113,498
27,44,106,95,78,87,437
23,31,83,87,82,88,394
16,33,116,108,74,68,415
53,73,187,191,182,173,859
24,23,70,96,103,96,412
17,29,93,96,74,60,369
13,25,55,54,41,46,234
50,65,180,184,145,157,781
13,18,42,45,25,27,170
39,44,129,124,109,127,572
42,60,157,164,139,141,703
20,26,63,64,59,83,315
17,17,52,57,57,59,259
33,42,115,121,100,104,515
24,36,96,104,93,98,451
14,16,52,53,53,66,254
40,51,149,144,117,117,618
20,49,123,127,85,76,480
27,40,93,103,90,84,437
9,13,35,29,21,21,128
27,46,111,100,93,112,489
6,12,25,36,29,22,130
13,20,49,54,51,48,235
41,51,144,140,126,135,637
39,63,150,155,131,125,663
34,42,133,133,112,130,584
11,25,74,79,49,46,284
20,41,102,98,78,53,392
31,45,127,123,96,102,524
8,6,5,3,4,9,35
12,21,46,39,47,51,216
26,33,81,78,80,80,378
41,47,132,134,122,133,609
24,31,91,88,68,72,374
50,66,176,150,131,151,724
30,35,104,110,97,108,484
25,50,142,129,87,76,509
41,54,138,138,115,124,610
38,54,163,187,173,161,776
16,37,101,100,80,62,396
24,26,83,93,66,64,356
51,71,187,181,160,160,810
30,45,136,142,113,108,574
23,36,94,82,85,87,407
45,60,167,177,155,160,764
55,72,197,202,170,180,876
47,67,197,192,151,150,804
27,29,83,95,72,67,373
12,21,41,42,27,31,174
42,53,134,141,120,137,627
26,41,104,94,88,119,472
40,61,171,183,149,145,749
3,1,3,7,11,8,33
25,26,100,106,80,86,423
23,37,84,85,81,74,384
40,54,146,149,124,143,656
20,49,141,144,95,72,521
7,12,25,38,27,27,136
15,34,95,103,68,65,380
16,44,118,103,79,57,417
32,55,135,159,145,140,666
26,32,96,99,86,97,436
41,60,144,148,126,126,645
24,27,90,102,80,94,417
20,36,86,83,83,84,392
26,30,87,89,77,63,372
8,26,63,74,68,36,275
45,60,166,176,155,160,762
42,65,169,194,164,170,804
5,3,4,7,7,4,30
41,55,159,177,150,150,732
26,49,132,126,98,78,509
50,62,171,168,123,139,713
29,52,128,125,91,99,524
20,33,67,63,61,80,324
15,38,84,68,45,46,296
4,3,3,4,6,10,30
19,23,66,72,52,54,286
6,12,23,25,18,20,104
18,27,69,77,63,69,323
16,37,82,90,74,71,370
13,35,96,93,73,55,365
21,33,82,71,58,54,319
20,31,84,82,68,64,349
26,40,101,97,89,99,452
20,38,93,97,92,81,421
24,23,73,63,57,58,298
22,26,88,94,83,88,401
21,29,83,84,76,71,364
26,27,93,106,99,106,457
5,3,5,3,4,6,26
3,3,5,8,6,11,36
3,2,6,13,9,5,38
19,35,85,95,80,83,397
25,24,74,72,70,70,335
46,67,184,183,161,162,803
17,26,75,85,73,68,344
10,16,54,61,48,44,233
11,12,35,43,25,25,151
39,52,144,157,138,147,677
48,63,170,161,155,158,755
15,22,59,44,51,53,244
38,50,139,140,114,124,605
40,56,149,146,120,124,635
43,66,177,182,149,158,775
15,39,110,100,62,55,381
39,64,164,171,141,150,729
39,50,151,143,122,132,637
7,7,4,6,8,10,42
35,49,141,145,127,129,626
4,6,20,22,15,12,79
41,51,130,122,124,136,604
39,48,137,137,121,135,617
22,18,69,75,66,67,317
17,38,89,96,83,82,405
29,37,100,105,99,98,468
19,38,100,88,58,57,360
37,50,155,156,161,145,704
11,10,33,36,30,33,153
39,55,167,162,143,145,711
5,20,56,56,45,35,217
47,58,167,159,135,131,697
34,53,147,150,130,126,640
8,16,37,43,41,38,183
27,24,90,93,86,89,409
35,51,142,140,125,132,625
24,34,71,77,68,72,346
37,57,146,145,124,134,643
18,32,101,101,70,58,380
38,60,159,152,127,139,675
43,64,161,159,139,143,709
24,31,74,73,71,74,347
32,42,135,154,126,123,612
38,52,147,142,132,132,643
34,46,116,129,110,103,538
3,2,3,5,4,7,24
11,24,95,100,66,62,358
19,39,108,101,69,59,395
12,21,46,37,46,48,210
2,2,4,6,7,4,25
15,24,67,55,54,67,282
30,46,118,132,115,109,550
23,44,127,124,93,70,481
4,4,10,17,15,11,61
9,8,22,31,20,19,109
4,2,3,6,2,4,21
22,40,115,113,82,61,433
40,69,170,177,142,156,754
21,29,82,80,67,76,355
27,28,95,97,79,103,429
11,13,40,53,42,28,187
37,64,180,182,152,158,773
14,40,116,114,72,66,422
18,45,112,96,65,53,389
15,29,74,57,54,57,286
47,61,159,163,158,152,740
0,2,2,1,2,9,16
37,49,132,149,136,129,632
3,7,16,13,8,10,57
44,56,168,166,161,161,756
24,25,102,109,78,80,418
3,5,6,5,9,13,41
34,44,136,128,111,120,573
8,32,83,73,48,37,281
16,26,67,77,75,66,327
47,65,173,171,152,162,770
8,18,47,45,27,27,172
16,28,69,86,73,66,338
24,36,104,101,90,81,436
42,67,168,175,152,150,754
3,3,2,2,5,8,23
16,38,114,97,64,73,402
8,12,46,45,43,40,194
22,36,97,106,74,77,412
10,12,33,32,30,32,149
8,13,31,37,36,42,167
37,51,141,145,123,142,639
43,58,161,158,140,144,704
4,2,2,2,1,8,19
17,40,127,109,66,57,416
39,48,128,123,130,138,606
35,55,150,161,134,134,669
50,69,177,178,158,160,792
18,39,115,101,77,80,430
5,6,10,19,9,12,61
9,21,62,69,46,49,256
45,60,170,156,156,167,754
11,33,94,94,59,41,332
3,7,14,12,6,7,49
7,6,3,6,5,0,27
35,51,139,137,101,110,573
45,62,172,170,160,154,763
34,47,139,138,115,117,590
48,70,182,184,166,156,806
34,48,126,130,120,122,580
38,53,144,138,130,149,652
40,55,148,141,119,124,627
31,48,139,145,117,123,603
28,40,106,115,97,106,492
23,28,77,81,72,74,355
16,45,139,124,74,61,459
48,60,172,168,158,146,752
14,20,62,72,55,61,284
35,49,136,146,135,146,647
37,64,181,183,152,158,775
5,6,21,20,18,20,90
18,20,66,81,74,65,324
5,7,22,23,20,20,97
28,57,142,146,136,140,649
20,51,141,135,106,89,542
5,3,4,2,2,6,22
37,49,144,161,133,143,667
18,48,112,111,78,51,418
50,71,178,179,161,168,807
2,2,2,5,2,4,17
33,41,104,113,97,93,481
32,43,110,112,101,104,502
42,57,167,174,149,156,745
12,20,40,46,30,27,175
20,35,73,79,81,83,371
34,49,136,151,114,128,612
47,57,181,190,151,164,790
19,33,94,94,74,70,384
31,57,154,158,132,136,668
0,6,12,10,9,12,49
36,52,147,140,113,137,625
40,51,141,130,122,134,618
46,66,179,164,151,157,763
3,1,2,3,5,9,23
38,53,163,178,153,145,730
40,63,176,180,153,166,778
45,65,169,168,134,151,732
47,65,168,160,133,152,725
3,5,7,7,6,6,34
3,2,3,5,3,3,19
11,24,58,58,38,43,232
11,17,40,49,49,38,204
35,45,121,130,120,123,574
40,64,161,163,149,147,724
3,1,5,5,4,5,23
39,59,152,148,132,135,665
16,36,91,94,69,63,369
43,65,163,167,145,156,739
25,40,106,111,106,104,492
37,50,149,151,134,143,664
4,5,12,12,7,8,48
47,50,162,170,156,162,747
5,4,14,14,10,10,57
19,48,139,131,95,91,523
38,56,141,141,131,145,652
18,27,78,95,77,76,371
35,47,134,151,125,128,620
21,35,89,90,90,82,407
44,68,186,190,166,171,825
5,7,18,34,30,26,120
32,40,111,117,111,116,527
20,30,95,93,81,80,399
18,23,68,84,67,71,331
38,53,148,141,121,121,622
12,30,76,77,59,45,299
39,53,156,156,131,125,660
45,60,177,189,174,171,816
9,28,87,78,60,46,308
39,57,168,172,148,147,731
26,41,101,107,99,96,470
35,40,121,129,108,126,559
4,9,20,18,13,16,80
39,53,157,155,133,145,682
16,39,124,115,74,76,444
28,33,91,96,84,95,427
17,42,126,109,74,73,441
3,3,6,18,19,14,63
36,60,163,167,136,150,712
43,53,152,154,135,127,664
2,1,1,1,1,2,8
19,28,76,76,76,79,354
21,24,79,82,68,70,344
24,29,78,88,67,68,354
25,42,134,127,90,78,496
12,13,60,70,42,37,234
10,14,38,56,40,34,192
18,44,158,163,105,102,590
23,27,71,80,69,74,344
33,65,214,212,142,116,782
1,1,0,2,2,2,8
3,4,4,2,0,2,15
31,38,109,111,96,95,480
25,50,145,151,101,99,571
29,60,189,176,108,98,660
28,44,114,102,89,96,473
27,34,105,115,88,86,455
19,31,68,86,65,66,335
22,46,147,147,105,71,538
7,15,49,55,52,45,223
7,5,5,9,7,3,36
9,14,48,56,44,40,211
0,1,2,2,1,2,8
11,14,40,41,32,35,173
22,52,141,129,89,79,512
35,64,177,168,123,116,683
26,30,69,71,65,69,330
29,50,154,138,90,76,537
12,34,100,102,60,53,361
9,17,47,58,46,53,230
3,4,5,3,1,0,16
12,14,56,58,47,37,224
25,23,80,93,71,63,355
23,33,103,108,94,95,456
4,9,24,12,9,13,71
5,2,7,4,5,6,29
24,26,100,93,81,89,413
31,41,90,86,61,75,384
28,39,93,97,85,88,430
10,19,43,49,33,37,191
22,50,131,128,81,80,492
17,30,76,89,85,70,367
14,40,104,84,66,66,374
34,63,200,185,117,112,711
3,5,8,10,9,4,39
25,42,101,100,91,85,444
1,0,2,5,3,4,15
28,59,194,189,121,108,699
4,4,9,6,9,14,46
25,53,159,145,101,95,578
32,42,99,85,76,72,406
13,20,55,55,52,43,238
21,38,122,128,73,59,441
26,52,155,154,110,91,588
31,73,203,198,135,105,745
26,30,67,64,71,58,316
0,1,1,1,2,1,6
27,41,106,118,102,94,488
19,34,77,80,67,76,353
12,18,59,54,43,35,221
18,31,81,89,84,81,384
13,25,72,89,71,52,322
26,31,102,126,102,89,476
23,42,101,108,102,111,487
26,58,201,199,129,105,718
12,25,93,88,56,45,319
24,37,112,102,94,81,450
18,41,134,117,70,58,438
23,25,83,87,86,62,366
32,66,186,177,114,100,675
26,33,87,93,79,96,414
7,16,55,66,43,36,223
22,30,64,53,43,65,277
9,14,35,37,28,27,150
16,21,62,74,48,42,263
11,12,31,29,28,36,147
5,4,4,7,13,12,45
19,15,54,58,50,65,261
29,65,209,209,143,108,763
18,45,117,130,88,78,476
8,15,38,47,40,38,186
3,3,2,4,6,6,24
41,67,220,207,122,91,748
5,5,6,6,10,5,37
2,1,1,2,4,4,14
14,30,94,100,66,52,356
12,20,62,63,44,42,243
33,67,185,168,118,99,670
9,8,14,13,9,6,59
13,47,129,131,73,67,460
31,51,167,163,114,96,622
27,29,101,88,84,100,429
23,48,131,135,97,70,504
23,31,90,98,86,72,400
10,11,36,54,39,32,182
33,66,200,211,137,111,758
33,46,110,123,111,111,534
3,2,3,0,1,3,12
2,2,3,7,4,5,23
17,45,124,108,75,59,428
23,26,88,110,89,66,402
19,30,72,87,90,92,390
31,44,114,115,94,103,501
2,3,2,4,1,5,17
16,18,50,49,34,39,206
23,34,75,75,79,92,378
17,48,118,117,71,72,443
10,12,43,40,38,35,178
10,14,38,49,31,31,173
27,61,163,167,111,90,619
6,5,4,3,5,7,30
0,0,1,2,2,0,5
21,60,159,173,131,96,640
19,27,85,91,78,70,370
2,2,2,5,6,7,24
33,48,109,124,112,95,521
35,64,210,200,137,109,755
23,35,102,93,94,84,431
2,2,2,4,5,7,22
1,2,1,3,4,2,13
3,3,6,9,2,4,27
18,25,77,73,47,45,285
12,13,34,27,20,25,131
14,38,121,112,74,67,426
3,1,5,3,2,1,15
27,59,172,162,108,86,614
6,14,41,50,34,34,179
11,13,41,37,31,33,166
11,16,40,43,35,24,169
2,3,4,3,3,6,21
28,38,101,107,87,85,446
6,5,5,3,5,8,32
7,17,38,37,23,36,158
21,29,106,89,55,44,344
21,28,79,80,74,63,345
8,6,16,18,20,14,82
8,11,23,27,25,14,108
21,39,111,105,79,82,437
3,4,3,3,0,0,13
0,1,1,1,1,6,10
28,59,169,178,119,96,649
30,50,118,114,105,121,538
5,2,7,4,5,5,28
29,41,99,98,95,94,456
34,61,180,174,109,102,660
21,41,94,101,89,82,428
0,0,0,3,3,4,10
27,33,79,86,66,81,372
10,15,43,45,34,42,189
25,58,172,173,113,96,637
8,14,36,43,31,31,163
22,53,155,157,104,90,581
14,15,48,44,36,40,197
18,24,64,59,41,43,249
22,50,176,162,104,83,597
17,43,123,111,75,55,424
38,71,207,202,136,104,758
14,20,59,52,45,35,225
13,17,50,47,34,47,208
22,29,86,78,69,68,352
10,29,87,100,64,57,347
24,57,167,171,117,109,645
6,4,8,8,8,17,51
8,13,50,60,51,53,235
27,37,106,112,94,93,469
9,33,74,73,68,61,318
37,51,154,157,134,122,655
21,16,50,60,47,49,243
46,66,164,172,148,156,752
5,4,3,4,7,13,36
8,13,31,21,27,43,143
9,19,34,44,39,27,172
27,36,95,99,96,109,462
25,31,88,97,84,72,397
22,33,77,76,67,89,364
30,38,99,108,93,87,455
39,60,163,165,138,146,711
25,42,110,109,82,86,454
32,45,120,119,106,105,527
26,41,108,110,104,74,463
21,34,74,93,88,82,392
6,4,14,10,10,12,56
42,66,181,172,140,149,750
38,50,122,136,115,98,559
36,66,180,163,128,132,705
5,2,3,1,2,7,20
13,27,66,70,55,78,309
28,39,80,87,86,82,402
32,48,109,121,120,104,534
17,28,67,66,55,51,284
21,25,71,76,74,87,354
42,69,157,158,144,148,718
36,47,129,143,118,114,587
41,54,144,149,142,126,656
31,44,107,122,113,115,532
46,62,170,152,128,145,703
48,53,146,161,145,141,694
33,49,134,143,138,137,634
36,49,150,148,128,150,661
30,68,211,201,139,114,763
0,0,1,2,3,3,9
25,43,114,118,106,99,505
22,29,87,90,72,57,357
3,3,3,2,0,0,11
35,61,208,195,140,113,752
38,53,141,143,119,126,620
35,51,127,128,110,115,566
15,14,52,54,40,37,212
51,62,170,179,154,146,762
37,53,139,147,126,128,630
36,50,134,127,105,118,570
3,7,14,17,17,23,81
36,55,138,144,119,128,620
24,30,89,92,74,71,380
28,36,103,117,91,84,459
7,9,10,8,6,5,45
26,28,67,78,78,86,363
34,51,138,132,107,119,581
34,56,138,148,135,134,645
35,47,142,141,108,127,600
12,21,37,23,28,31,152
35,53,155,145,118,146,652
2,3,3,5,6,6,25
45,59,153,152,137,157,703
35,40,106,104,95,101,481
30,46,120,121,109,95,521
42,57,145,148,122,123,637
49,59,162,164,148,149,731
27,42,99,103,93,93,457
26,29,69,58,49,42,273
5,9,13,11,10,16,64
2,3,6,5,1,4,21
40,64,155,156,139,147,701
1,3,4,5,5,3,21
39,50,139,143,125,125,621
19,25,66,79,63,69,321
27,41,122,120,102,102,514
40,53,129,132,113,104,571
14,20,59,69,61,65,288
29,52,131,138,123,117,590
30,40,101,94,90,113,468
7,20,40,57,47,37,208
23,36,102,98,90,108,457
0,0,0,2,2,0,4
41,57,148,146,126,130,648
43,65,161,163,148,150,730
40,65,155,155,135,148,698
30,48,132,136,121,122,589
28,32,105,93,96,98,452
30,38,116,114,109,105,512
12,15,55,58,47,48,235
42,51,134,133,112,126,598
36,56,138,127,115,115,587
10,9,18,15,6,12,70
36,62,206,196,119,101,720
15,13,63,61,46,54,252
35,53,137,137,126,138,626
49,60,167,169,143,157,745
2,2,3,3,2,1,13
10,29,53,56,51,54,253
31,37,102,96,84,97,447
4,3,2,4,4,4,21
4,3,4,4,7,7,29
33,43,115,127,105,120,543
45,55,152,161,120,117,650
50,61,171,160,145,147,734
38,58,148,139,131,132,646
26,40,119,122,108,107,522
35,52,140,140,123,133,623
27,41,121,120,102,102,513
22,31,81,84,82,85,385
34,50,136,133,119,124,596
22,32,96,118,96,84,448
6,6,4,2,3,5,26
36,53,143,140,128,124,624
36,56,144,158,139,143,676
41,68,167,155,138,143,712
31,40,104,103,102,105,485
40,44,119,103,95,104,505
17,17,54,52,50,50,240
5,11,26,29,26,19,116
23,41,113,114,86,103,480
21,31,87,80,57,64,340
38,54,143,135,118,119,607
31,43,126,133,111,112,556
49,66,172,180,161,159,787
22,36,88,88,87,81,402
42,56,156,149,130,135,668
37,35,126,137,115,112,562
5,5,5,2,2,6,25
37,44,143,138,115,107,584
50,63,167,177,145,157,759
33,59,194,170,112,95,663
35,54,137,140,118,117,601
28,47,120,130,121,115,561
4,4,5,2,3,3,21
4,3,2,5,3,7,24
34,57,150,131,120,126,618
39,46,135,133,119,129,601
10,11,36,43,37,38,175
25,39,96,86,71,88,405
48,64,173,170,141,151,747
32,38,89,94,96,82,431
48,65,169,164,150,162,758
3,4,8,13,9,9,46
28,64,200,181,118,102,693
39,46,133,133,121,109,581
34,47,121,118,109,126,555
5,11,30,26,21,23,116
1,2,8,7,2,3,23
8,11,40,47,35,30,171
6,13,43,42,28,34,166
2,6,18,16,7,12,61
0,38,61,69,42,0,210
0,0,0,1,0,0,1
0,43,70,56,37,0,206
0,31,60,58,36,0,185
0,30,57,72,43,0,202
0,33,48,59,42,0,182
0,11,17,16,8,0,52
0,18,32,37,21,0,108
0,37,52,55,35,0,179
0,24,37,38,27,0,126
0,27,42,53,35,0,157
0,12,20,33,25,0,90
0,1,3,7,7,0,18
0,8,15,17,11,0,51
0,36,59,63,38,0,196
0,35,57,56,35,0,183
0,4,3,2,2,0,11
0,31,49,56,33,0,169
0,32,49,61,39,0,181
0,35,52,58,37,0,182
0,4,3,0,0,0,7
0,23,38,41,25,0,127
0,27,48,56,38,0,169
0,29,47,50,33,0,159
0,3,5,4,3,0,15
0,35,49,51,33,0,168
0,23,38,41,26,0,128
0,31,53,62,37,0,183
0,1,1,1,1,0,4
0,32,51,54,30,0,167
0,32,44,46,32,0,154
0,0,1,1,0,0,2
0,19,37,44,29,0,129
0,19,31,27,16,0,93
0,25,42,49,32,0,148
0,29,49,54,35,0,167
0,31,49,56,33,0,169
0,29,49,54,35,0,167
0,20,33,42,25,0,120
0,33,51,55,35,0,174
0,29,49,53,33,0,164
0,34,48,52,33,0,167
0,10,12,11,8,0,41
0,35,49,56,37,0,177
0,34,44,53,33,0,164
0,40,51,56,37,0,184
0,28,41,44,27,0,140
0,36,50,51,32,0,169
0,0,0,1,1,0,2
0,30,43,56,34,0,163
0,40,51,56,37,0,184
0,35,52,56,34,0,177
0,20,22,17,10,0,69
0,11,16,11,7,0,45
0,35,47,55,36,0,173
0,30,47,59,36,0,172
0,12,20,24,14,0,70
0,35,43,56,38,0,172
0,4,8,13,9,0,34
0,25,33,36,21,0,115
0,36,47,59,39,0,181
0,30,43,53,29,0,155
0,6,7,11,8,0,32
0,7,13,18,10,0,48
0,15,22,24,14,0,75
0,33,48,54,34,0,169
0,10,16,12,9,0,47
0,3,2,3,2,0,10
0,25,37,39,25,0,126
0,10,15,12,6,0,43
0,32,46,49,30,0,157
0,2,3,1,0,0,6
12,23,50,47,37,39,208
46,71,186,188,160,173,824
26,31,90,103,90,79,419
12,18,28,34,31,30,153
37,54,144,146,126,141,648
44,61,169,171,139,158,742
50,64,191,182,145,167,799
43,59,175,181,163,173,794
44,63,180,178,162,164,791
27,38,110,114,108,112,509
15,21,34,41,36,33,180
55,72,204,196,169,173,869
6,12,25,36,29,24,132
42,57,148,145,120,127,639
45,57,182,192,151,155,782
55,72,204,196,169,173,869
50,69,185,194,173,169,840
45,57,175,177,143,154,751
49,63,166,169,153,162,762
9,13,31,39,25,23,140
11,19,47,50,42,39,208
14,14,45,45,40,39,197
47,72,193,185,156,154,807
11,16,36,41,26,31,161
54,68,202,196,165,162,847
44,57,169,166,147,138,721
47,65,189,217,182,185,885
52,74,194,191,170,175,856
16,23,46,49,40,45,219
47,60,162,160,135,148,712
55,80,197,205,171,193,901
28,45,113,104,94,107,491
45,63,195,206,172,172,853
12,18,40,44,33,37,184
11,19,33,40,39,38,180
31,50,127,141,115,103,567
40,55,147,149,125,135,651
46,60,179,172,152,161,770
41,67,158,148,128,151,693
30,43,95,87,85,72,412
17,44,138,138,98,92,527
28,37,104,107,86,95,457
45,63,174,169,131,130,712
11,23,44,45,34,32,189
35,58,163,174,140,123,693
41,59,150,161,146,149,706
10,17,34,40,32,29,162
45,63,172,167,131,130,708
40,58,177,195,168,159,797
45,58,171,177,148,148,747
60,68,177,193,172,159,829
49,65,179,185,155,170,803
43,53,168,174,143,144,725
12,18,40,43,33,37,183
47,61,175,175,151,158,767
45,59,183,195,176,161,819
47,70,188,201,167,185,858
16,32,86,83,72,69,358
12,25,43,51,40,33,204
46,70,178,203,169,165,831
53,77,201,173,160,185,849
13,18,34,38,23,30,156
47,73,190,193,161,165,829
46,59,162,158,141,136,702
47,65,191,168,145,157,773
55,67,187,181,151,174,815
35,50,143,149,131,132,640
5,3,5,5,3,2,23
48,63,175,177,151,152,766
43,65,187,196,168,155,814
43,65,194,192,163,158,815
58,72,190,197,170,164,851
50,70,182,189,159,147,797
47,66,196,198,181,171,859
35,57,141,158,132,150,673
40,59,166,174,147,168,754
27,37,93,104,88,96,445
45,76,193,195,172,179,860
26,35,91,100,93,98,443
39,63,151,156,140,132,681
43,61,149,139,126,142,660
47,70,178,189,167,180,831
47,68,176,190,162,178,821
13,18,44,48,35,34,192
38,53,150,164,140,151,696
50,63,185,189,176,169,832
43,62,170,164,152,161,752
13,22,38,51,37,39,200
14,21,56,62,41,49,243
18,33,83,90,83,80,387
39,57,167,175,152,168,758
22,35,64,71,66,53,311
41,61,149,156,146,137,690
40,57,166,171,149,150,733
45,58,168,170,149,148,738
34,55,132,137,122,124,604
16,27,60,62,51,56,272
44,76,180,191,159,156,806
27,30,79,83,69,55,343
27,41,117,114,98,120,517
44,65,162,179,147,150,747
41,54,170,191,154,146,756
50,69,183,192,174,167,835
23,26,81,93,79,79,381
41,63,172,169,140,141,726
49,76,177,188,175,174,839
41,66,160,177,155,171,770
38,58,161,157,136,144,694
39,49,142,158,133,132,653
40,62,138,138,117,131,626
15,21,40,45,41,37,199
54,70,198,201,162,161,846
35,48,117,131,119,131,581
36,69,163,178,158,147,751
14,16,35,38,31,29,163
27,31,94,110,93,73,428
47,66,186,195,172,168,834
56,79,196,208,178,167,884
51,59,191,179,157,162,799
14,19,37,43,31,28,172
40,59,148,148,138,128,661
50,69,188,193,162,170,832
9,13,34,43,23,27,149
10,15,38,45,36,26,170
43,64,173,181,160,158,779
50,68,182,198,174,174,846
12,19,39,38,33,37,178
55,66,183,187,166,172,829
46,59,171,160,137,158,731
44,60,170,185,175,183,817
46,69,193,192,165,176,841
51,56,177,182,165,182,813
38,61,150,146,126,123,644
2,36,51,54,38,6,187
47,62,172,188,172,185,826
46,77,196,186,166,183,854
34,56,131,133,117,104,575
44,62,169,174,149,159,757
24,23,81,77,65,65,335
2,1,4,5,4,2,18
3,2,6,6,10,8,35
49,66,187,192,170,180,844
49,65,179,191,181,172,837
52,74,202,191,163,167,849
45,66,170,192,183,185,841
18,26,78,73,62,73,330
45,71,174,182,172,189,833
47,73,188,201,178,192,879
52,71,190,185,167,176,841
48,71,188,197,165,170,839
54,74,190,192,161,169,840
50,73,189,194,171,169,846
46,70,186,185,156,161,804
48,71,182,189,172,171,833
43,68,188,183,164,175,821
43,67,186,182,164,175,817
46,70,186,185,156,161,804
54,67,184,200,170,169,844
46,68,173,185,166,172,810
1,0,1,0,0,0,2
49,67,173,177,168,168,802
52,68,177,184,167,170,818
47,67,192,191,162,172,831
48,69,172,180,157,164,790
57,67,190,200,177,185,876
53,73,190,194,189,196,895
49,64,182,190,176,186,847
46,68,184,191,158,159,806
47,68,199,205,170,171,860
49,71,191,189,167,175,842
43,69,180,186,160,187,825
56,74,174,177,171,172,824
51,71,185,194,160,170,831
46,70,186,187,166,181,836
52,74,198,194,167,162,847
49,70,177,180,159,161,796
8,11,45,37,30,24,155
18,39,116,112,75,64,424
29,62,176,175,111,92,645
15,21,59,68,48,37,248
10,18,57,62,42,31,220
29,48,108,108,100,107,500
20,19,58,51,49,58,255
12,19,63,60,50,38,242
21,33,95,94,78,77,398
23,54,164,161,106,92,600
24,35,88,102,86,98,433
32,43,118,117,98,104,512
30,52,130,143,135,133,623
52,68,196,186,166,175,843
25,41,94,102,91,88,441
44,59,165,177,151,151,747
31,40,110,99,78,98,456
39,62,165,169,146,158,739
42,59,171,168,157,148,745
53,68,189,186,166,173,835
41,56,160,168,141,142,708
423,1105,2251,2251,2015,2225,10270
42,57,148,144,117,126,634
39,54,166,168,144,149,720
23,33,78,85,80,72,371
22,29,85,82,56,55,329
49,70,191,203,172,171,856
50,73,195,191,160,155,824
20,29,74,76,62,65,326
25,38,101,112,101,108,485
26,34,108,105,83,80,436
46,64,171,171,160,165,777
21,28,79,68,63,54,313
35,50,120,124,124,127,580
48,77,192,195,164,170,846
43,61,163,168,133,156,724
52,73,179,173,156,161,794
15,25,69,79,72,80,340
334,812,1625,1625,1402,1559,7357
29,35,95,113,106,115,493
56,76,196,184,155,159,826
33,50,152,164,143,141,683
29,34,96,105,98,103,465
16,25,80,86,69,68,344
20,36,93,104,89,101,443
22,28,85,96,73,89,393
41,62,155,145,134,127,664
33,43,115,118,102,111,522
59,74,201,194,160,179,867
18,26,58,68,73,63,306
22,31,84,88,74,74,373
47,69,186,167,145,136,750
33,46,116,129,115,114,553
34,49,122,121,119,118,563
48,63,186,184,159,171,811
49,65,190,194,160,165,823
23,21,81,81,59,59,324
20,36,98,108,109,115,486
29,41,101,112,90,83,456
43,64,151,146,132,151,687
44,65,173,181,151,165,779
12,23,83,80,61,70,329
49,68,175,175,150,156,773
42,59,184,175,152,160,772
56,72,185,184,156,173,826
55,75,189,178,156,155,808
54,76,191,182,160,182,845
28,39,123,120,100,111,521
38,58,142,145,123,125,631
39,51,139,145,124,135,633
34,46,119,115,103,102,519
22,30,86,82,69,84,373
37,52,152,151,130,139,661
26,42,106,111,110,105,500
20,28,78,92,75,79,372
30,43,129,129,112,116,559
47,66,180,186,165,165,809
25,29,85,84,70,61,354
42,70,180,187,153,162,794
16,19,59,50,43,51,238
45,63,171,185,146,154,764
37,51,150,150,130,139,657
28,40,104,108,94,87,461
25,40,110,111,93,91,470
37,49,133,150,134,114,617
44,66,162,161,136,150,719
43,57,164,169,140,162,735
42,56,149,148,145,136,676
39,54,148,140,117,133,631
27,44,110,107,92,95,475
23,32,79,84,75,83,376
35,57,149,156,126,126,649
37,46,144,151,135,138,651
48,60,176,174,147,145,750
46,64,161,177,155,146,749
37,50,160,156,127,140,670
26,39,116,126,101,100,508
49,64,173,179,147,145,757
42,57,170,177,153,165,764
53,71,182,204,161,165,836
25,27,92,94,87,88,413
52,72,192,194,176,178,864
38,64,166,180,156,158,762
36,58,139,144,130,144,651
35,58,149,157,134,128,661
25,34,88,100,93,85,425
21,29,73,81,83,75,362
27,48,102,90,80,78,425
35,52,132,135,127,138,619
45,60,164,155,147,149,720
52,72,186,191,166,161,828
4,3,3,1,2,4,17
34,50,120,134,108,130,576
39,52,128,126,118,127,590
40,54,146,147,136,149,672
30,47,125,128,95,113,538
26,45,86,88,92,94,431
42,61,146,146,127,129,651
30,45,114,110,80,94,473
27,40,108,125,114,109,523
27,40,97,99,86,100,449
5,3,4,7,10,16,45
33,47,121,133,117,117,568
40,58,140,145,131,149,663
51,69,184,185,166,153,808
33,41,111,113,97,100,495
26,44,115,109,78,86,458
27,36,116,116,93,97,485
34,41,101,109,101,91,477
30,53,132,141,133,132,621
23,34,82,80,63,67,349
23,30,79,92,85,84,393
14,29,70,77,59,57,306
14,26,66,75,53,73,307
26,37,87,85,75,78,388
34,48,121,126,108,105,542
52,68,185,176,153,170,804
47,64,176,175,154,162,778
15,17,63,73,52,48,268
49,71,193,200,183,183,879
40,54,147,156,126,122,645
48,71,176,174,149,165,783
54,76,197,189,159,165,840
38,55,130,135,118,126,602
43,60,151,146,127,128,655
51,72,193,196,171,173,856
815,2383,4725,4790,3734,4641,21088
34,52,120,121,101,107,535
39,63,179,189,164,177,811
51,66,185,179,159,150,790
50,75,186,180,170,180,841
47,68,191,186,166,171,829
54,76,197,188,165,169,849
4,4,5,8,6,8,35
40,59,146,144,128,134,651
48,67,200,202,162,158,837
48,57,179,174,150,162,770
32,48,126,120,102,100,528
35,55,143,134,115,124,606
46,69,174,167,152,142,750
36,54,135,145,136,117,623
46,70,164,181,166,174,801
42,68,174,183,158,168,793
45,62,173,164,160,161,765
34,50,133,132,117,120,586
0,39,68,68,36,0,211
30,45,121,135,126,123,580
43,57,155,160,138,160,713
27,48,126,128,107,108,544
45,65,185,188,158,167,808
38,54,145,154,147,146,684
50,72,192,183,168,175,840
60,71,196,194,176,164,861
35,45,129,131,111,142,593
41,60,169,175,157,158,760
37,44,122,132,113,105,553
47,64,170,171,156,165,773
49,68,186,184,165,173,825
86,150,362,350,383,354,1685
33,41,106,119,104,96,499
46,70,177,177,171,178,819
35,52,154,157,131,134,663
46,64,164,167,151,156,748
36,52,129,139,130,120,606
34,56,136,120,107,108,561
47,65,170,172,156,156,766
53,70,197,196,175,185,876
18,19,68,60,49,61,275
51,68,191,207,167,175,859
44,60,161,162,141,152,720
50,70,181,173,159,180,813
49,64,175,170,160,173,791
30,52,122,124,101,111,540
39,57,167,180,157,165,765
51,64,177,171,149,165,777
48,70,171,176,152,170,787
54,72,188,194,175,174,857
49,68,200,185,164,175,841
0,36,66,57,34,0,193
47,62,176,171,145,169,770
48,77,204,183,153,174,839
41,58,160,164,142,137,702
36,53,126,130,114,113,572
19,41,84,82,67,42,335
45,60,173,192,164,160,794
39,63,178,187,165,176,808
42,53,134,130,101,130,590
20,36,101,105,90,95,447
42,58,151,159,148,144,702
32,42,120,130,111,117,552
26,38,105,109,88,82,448
37,49,132,136,117,138,609
47,71,190,179,162,170,819
34,48,132,138,114,127,593
43,58,165,166,139,142,713
47,68,197,192,167,149,820
35,61,141,147,136,150,670
49,76,196,196,176,168,861
50,67,183,177,149,177,803
40,53,137,142,112,114,598
41,53,145,149,121,124,633
47,68,164,176,163,155,773
0,37,60,69,41,0,207
47,69,175,185,156,165,797
26,48,151,143,106,99,573
35,50,119,115,108,111,538
52,77,203,211,175,188,906
17,26,69,73,46,49,280
10,46,127,123,82,50,438
16,25,66,72,53,49,281
41,59,162,163,143,158,726
3,41,68,74,37,9,232
0,41,65,62,40,0,208
15,24,61,66,49,54,269
34,48,108,117,106,105,518
32,42,124,136,126,128,588
38,61,144,151,130,141,665
49,76,174,181,152,163,795
47,65,167,174,142,131,726
22,56,157,155,96,66,552
16,24,58,64,59,49,270
51,71,208,212,162,170,874
25,46,122,118,98,92,501
0,34,56,59,35,0,184
15,25,54,67,52,47,260
20,25,57,66,50,55,273
17,21,67,66,55,52,278
44,65,163,167,159,169,767
47,67,163,169,153,160,759
50,61,166,171,147,162,757
28,34,110,117,106,118,513
38,77,240,246,167,137,905
28,50,147,142,107,95,569
11,40,89,84,60,46,330
15,21,61,66,52,47,262
30,52,118,113,105,121,539
20,23,69,79,60,57,308
16,24,60,66,57,58,281
51,68,170,174,152,158,773
46,66,169,165,140,146,732
0,42,64,70,43,0,219
44,89,241,232,157,133,896
20,20,65,69,56,58,288
39,57,139,137,120,122,614
47,64,158,162,134,128,693
49,60,163,160,141,146,719
48,63,172,178,149,141,751
33,55,133,144,132,133,630
43,61,161,173,154,160,752
0,36,57,58,40,0,191
40,63,152,153,138,136,682
48,67,189,187,156,170,817
46,59,142,143,126,126,642
41,61,163,169,153,154,741
17,22,62,63,57,48,269
18,21,62,66,57,44,268
0,37,62,63,40,0,202
17,25,58,64,54,54,272
44,59,153,158,139,143,696
19,32,89,81,59,51,331
33,70,219,209,147,128,806
5,46,69,71,44,13,248
44,51,146,170,149,144,704
25,33,88,91,78,69,384
13,23,61,65,54,49,265
18,20,68,68,49,40,263
40,53,139,151,139,133,655
55,76,182,184,156,170,823
30,47,132,140,123,139,611
37,52,150,148,138,134,659
48,67,173,175,151,166,780
47,61,175,179,141,157,760
30,41,113,114,100,108,506
37,82,238,233,157,133,880
47,59,152,154,142,147,701
48,72,184,193,163,165,825
50,61,166,171,147,162,757
13,18,48,64,65,46,254
41,79,226,221,149,129,845
41,73,224,224,151,147,860
33,65,207,200,131,110,746
46,68,168,178,160,160,780
37,53,136,139,116,125,606
35,75,225,215,145,117,812
19,26,63,65,52,51,276
46,57,160,193,179,170,805
50,67,176,181,156,155,785
21,35,82,92,70,80,380
46,65,170,168,144,180,773
38,69,184,191,151,160,793
7,38,67,65,46,27,250
39,56,132,126,104,113,570
47,65,178,190,163,146,789
18,24,51,65,49,49,256
43,65,170,177,143,152,750
0,29,50,60,36,0,175
54,74,188,195,168,168,847
0,36,67,69,37,0,209
14,21,64,74,57,56,286
16,24,59,66,49,57,271
42,52,153,150,130,144,671
39,45,123,130,112,104,553
0,41,74,66,39,0,220
0,39,56,64,41,0,200
19,23,67,66,46,46,267
15,28,63,65,42,47,260
0,34,58,64,41,0,197
49,67,192,194,164,163,829
33,45,116,121,102,113,530
0,43,70,71,39,0,223
47,74,183,184,161,152,801
15,17,54,53,42,52,233
25,42,111,112,91,98,479
0,35,61,67,36,0,199
42,57,163,171,136,154,723
26,33,94,96,76,71,396
52,59,172,184,148,148,763
54,71,187,194,166,171,843
1,35,63,79,43,7,228
0,40,62,70,43,0,215
52,57,169,183,159,159,779
40,54,153,165,136,144,692
33,41,107,118,105,103,507
29,44,129,123,102,98,525
8,42,66,70,42,24,252
38,50,133,149,124,117,611
52,63,165,164,144,141,729
33,48,106,113,105,112,517
0,39,55,62,36,0,192
44,51,131,131,115,125,597
51,72,208,204,180,178,893
15,24,63,60,49,56,267
19,23,68,73,54,59,296
23,32,94,84,73,79,385
25,35,88,89,74,74,385
49,71,175,188,154,166,803
51,69,179,191,171,186,847
14,19,45,49,42,32,201
47,63,165,181,155,149,760
53,71,189,211,178,193,895
18,27,63,65,51,53,277
20,29,62,67,49,51,278
11,21,41,45,45,39,202
47,63,178,181,166,150,785
57,77,198,199,159,171,861
19,23,50,56,44,33,225
42,69,178,181,146,137,753
41,56,147,139,118,143,644
13,19,34,50,36,37,189
14,20,45,49,40,39,207
13,16,55,63,52,44,243
22,29,68,74,63,67,323
15,17,50,61,49,49,241
19,28,67,70,54,54,292
52,77,194,196,182,182,883
52,72,201,204,187,191,907
13,24,59,70,48,58,272
45,66,178,181,156,151,777
43,63,164,162,134,143,709
49,73,209,191,168,172,862
54,71,185,185,159,168,822
14,20,45,48,49,39,215
13,19,41,47,39,42,201
14,17,51,64,49,47,242
17,25,65,68,50,44,269
44,66,177,181,156,151,775
19,28,68,70,53,55,293
19,28,68,70,53,55,293
39,47,124,131,112,115,568
50,70,175,191,169,189,844
51,75,197,200,176,172,871
12,20,40,50,37,35,194
17,31,64,70,49,46,277
14,20,48,55,46,42,225
60,82,180,182,167,181,852
17,29,51,58,49,46,250
54,78,201,198,178,186,895
31,51,122,118,97,98,517
38,61,149,153,133,127,661
20,23,54,56,43,37,233
48,76,174,182,165,175,820
50,71,173,180,155,178,807
47,74,201,212,191,177,902
51,66,190,203,170,176,856
50,76,193,191,166,187,863
50,70,187,198,176,178,859
15,27,60,69,52,48,271
55,75,207,211,170,192,910
45,64,191,195,179,170,844
52,70,174,175,151,162,784
35,46,109,113,99,111,513
51,75,190,193,158,171,838
16,23,50,58,47,49,243
26,45,117,112,95,108,503
50,65,179,192,162,171,819
46,69,182,200,171,188,856
16,22,63,70,48,43,262
48,70,208,214,181,190,911
17,26,57,57,54,48,259
15,18,46,49,41,34,203
44,63,161,169,151,161,749
59,74,203,191,177,183,887
55,72,179,184,166,160,816
24,26,93,105,89,87,424
16,24,56,64,49,45,254
53,75,185,193,155,167,828
46,63,166,169,150,150,744
49,84,197,211,173,176,890
60,72,198,199,181,193,903
15,20,43,46,41,34,199
12,20,47,52,45,42,218
16,21,55,56,51,42,241
12,17,49,64,58,49,249
13,18,50,50,42,35,208
48,72,191,206,167,169,853
16,24,72,69,55,49,285
28,43,112,113,96,95,487
49,72,184,189,166,178,838
14,19,45,54,47,51,230
55,72,186,184,159,170,826
17,26,55,64,50,50,262
12,21,45,50,43,37,208
48,72,184,190,168,165,827
53,70,196,201,182,172,874
14,27,57,65,47,38,248
29,41,109,102,96,100,477
30,45,108,107,87,94,471
11,19,51,58,48,40,227
20,24,50,55,44,36,229
31,57,138,138,129,108,601
58,80,182,179,155,178,832
27,47,126,145,128,150,623
19,27,80,82,70,61,339
15,20,43,53,43,42,216
16,26,63,75,52,54,286
16,26,53,56,47,47,245
46,68,178,192,157,171,812
32,42,118,127,124,126,569
54,72,188,190,165,173,842
48,71,190,208,163,169,849
38,71,163,158,148,158,736
45,66,168,171,156,155,761
53,69,195,194,155,173,839
47,73,191,201,162,169,843
47,67,170,184,155,158,781
54,71,197,190,171,179,862
14,19,45,56,47,44,225
13,20,40,44,35,29,181
45,74,188,194,154,157,812
56,74,196,198,168,169,861
54,68,193,196,166,174,851
50,64,179,193,180,205,871
54,78,194,184,158,164,832
44,70,200,199,169,186,868
46,79,190,186,157,159,817
42,68,168,174,161,175,788
15,24,62,60,49,65,275
36,64,149,144,122,137,652
49,73,200,205,176,188,891
15,25,57,57,40,30,224
13,20,48,51,37,42,211
10,17,46,46,40,36,195
53,73,198,200,158,157,839
54,77,202,195,158,172,858
49,71,169,169,154,151,763
42,67,169,182,166,187,813
58,81,212,202,166,162,881
52,72,190,204,177,182,877
52,71,182,189,170,175,839
52,66,185,192,156,167,818
9,20,33,38,34,41,175
11,25,47,57,45,38,223
53,67,189,204,159,175,847
52,76,193,206,169,172,868
9,16,43,50,43,46,207
56,70,188,187,172,183,856
55,67,200,221,167,151,861
47,72,185,196,168,183,851
54,76,215,203,162,173,883
12,24,48,57,43,33,217
41,62,169,168,153,149,742
17,25,54,58,44,48,246
51,70,192,196,161,177,847
51,71,185,189,163,173,832
16,20,49,56,52,57,250
53,69,184,188,170,177,841
51,71,192,214,162,167,857
51,80,193,197,167,178,866
48,66,183,202,174,181,854
50,64,193,204,165,174,850
16,23,51,55,44,51,240
54,70,196,199,169,171,859
62,80,199,196,177,178,892
51,69,188,191,154,175,828
45,69,194,185,162,168,823
51,70,197,218,178,187,901
56,71,200,197,176,175,875
53,72,192,205,177,182,881
49,72,193,198,165,168,845
47,70,193,216,168,176,870
13,20,54,58,49,44,238
59,77,210,210,179,179,914
52,75,191,199,177,174,868
50,68,190,216,165,180,869
49,73,190,192,147,162,813
14,21,39,42,35,33,184
48,69,199,220,177,170,883
14,19,50,58,44,48,233
17,22,45,52,44,38,218
53,69,181,193,168,178,842
34,55,142,134,112,128,605
48,60,187,184,164,163,806
41,56,146,150,122,127,642
19,20,60,49,53,59,260
24,32,84,72,68,78,358
21,39,100,94,70,68,392
35,56,144,137,118,127,617
32,42,138,147,122,128,609
41,66,178,178,143,158,764
37,52,139,132,113,123,596
34,44,136,127,110,120,571
38,55,150,149,135,149,676
32,42,135,155,127,123,614
12,14,36,37,31,37,167
12,43,108,108,77,67,415
19,30,96,78,61,45,329
29,40,100,95,84,91,439
29,62,191,191,125,103,701
3,2,1,4,2,11,23
27,58,171,156,121,129,662
37,56,159,165,125,129,671
34,42,132,110,88,97,503
30,46,108,111,108,111,514
44,68,168,164,151,152,747
0,35,54,57,37,0,183
52,65,182,191,168,174,832
42,58,148,159,150,144,701
33,49,131,134,114,118,579
36,50,115,128,117,111,557
35,50,139,151,133,133,641
20,27,100,104,92,74,417
39,51,120,135,122,131,598
43,57,155,159,131,146,691
30,43,118,111,112,135,549
3,2,4,5,3,2,19
41,55,157,159,135,144,691
18,31,80,75,68,61,333
19,25,86,92,77,80,379
23,29,88,98,84,73,395
29,37,97,96,84,95,438
3,2,5,8,4,5,27
33,52,138,135,123,135,616
41,58,163,168,148,138,716
28,45,98,106,100,105,482
35,45,135,129,115,109,568
32,56,132,117,104,96,537
26,40,109,98,90,89,452
22,33,85,94,75,73,382
28,39,120,119,108,116,530
49,52,164,149,140,138,692
42,44,117,104,97,90,494
26,37,113,113,91,83,463
31,51,126,121,116,119,564
30,52,110,102,90,95,479
36,48,135,138,121,115,593
25,33,114,113,108,119,512
51,62,165,152,124,134,688
44,60,167,172,141,150,734
33,48,126,116,114,117,554
45,61,167,159,134,145,711
39,55,164,157,125,129,669
5,2,3,1,1,2,14
18,25,67,58,53,37,258
39,52,135,141,116,115,598
18,21,51,60,51,60,261
47,61,165,176,154,143,746
30,49,139,141,134,128,621
42,61,173,158,130,150,714
39,58,156,158,142,153,706
41,63,166,174,148,165,757
23,33,95,95,88,92,426
47,66,181,187,162,166,809
33,46,111,111,92,87,480
48,63,178,180,163,162,794
31,44,105,113,99,90,482
18,29,80,93,81,89,390
19,32,90,83,80,90,394
46,58,159,166,143,144,716
37,47,123,126,111,103,547
38,52,144,154,128,142,658
36,52,140,140,123,117,608
35,45,126,117,108,116,547
0,1,1,1,2,7,12
24,29,86,77,70,84,370
40,52,147,149,130,135,653
44,62,168,162,147,163,746
28,49,104,116,101,100,498
43,62,173,175,144,143,740
29,40,106,107,105,92,479
49,77,183,181,165,158,813
4,2,7,10,6,2,31
48,66,168,165,141,165,753
37,59,147,152,132,149,676
34,42,128,128,105,105,542
41,53,150,149,123,135,651
39,51,146,147,130,132,645
43,68,164,165,146,152,738
44,58,150,145,112,114,623
47,60,166,162,136,136,707
28,45,106,108,97,97,481
35,47,112,116,94,82,486
49,62,168,164,149,149,741
37,55,138,141,123,119,613
32,49,106,110,90,95,482
42,61,174,178,142,138,735
44,63,173,185,150,175,790
34,45,103,90,81,72,425
16,23,53,53,53,60,258
42,59,164,177,141,133,716
40,55,156,156,128,126,661
15,22,54,48,42,35,216
35,57,146,149,125,131,643
25,29,92,99,85,80,410
23,31,88,95,76,81,394
28,34,96,95,84,89,426
61,77,193,197,169,171,868
48,75,195,187,149,164,818
46,73,187,179,159,165,809
0,41,60,70,43,0,214
41,47,131,138,115,114,586
33,48,127,133,114,127,582
17,29,78,78,67,75,344
52,67,189,185,163,166,822
52,71,184,190,158,160,815
18,28,80,89,78,73,366
46,66,186,189,162,154,803
47,66,182,188,163,154,800
27,42,107,118,102,94,490
49,72,194,198,164,172,849
50,64,183,193,172,178,840
42,60,169,172,147,176,766
0,35,56,61,38,0,190
50,72,176,185,165,157,805
51,65,183,194,175,183,851
40,59,138,159,145,129,670
45,64,171,183,163,155,781
50,67,179,184,160,159,799
0,38,57,64,39,0,198
35,51,122,127,110,108,553
50,63,160,171,158,180,782
0,44,60,66,38,0,208
50,69,174,169,156,165,783
47,69,189,192,167,171,835
43,64,166,177,148,154,752
53,70,183,196,158,156,816
41,58,146,148,135,127,655
43,59,164,174,155,154,749
57,74,185,192,166,162,836
58,72,183,193,172,170,848
43,62,164,166,146,146,727
0,37,58,70,41,0,206
45,62,166,177,154,177,781
51,65,180,176,155,153,780
0,37,60,54,41,0,192
51,75,199,204,176,189,894
47,69,169,178,170,161,794
44,59,151,146,120,129,649
45,68,181,181,163,157,795
54,73,184,196,175,191,873
0,36,66,72,45,0,219
46,61,163,183,159,162,774
0,37,54,73,43,0,207
46,65,159,160,153,159,742
0,38,57,74,41,0,210
43,56,153,154,122,128,656
47,70,192,188,159,160,816
45,63,158,180,160,154,760
62,77,202,198,167,180,886
38,55,141,161,137,134,666
57,74,186,191,167,178,853
49,74,192,200,164,175,854
48,54,157,157,141,152,709
0,37,67,64,38,0,206
57,72,181,165,148,160,783
0,36,58,71,41,0,206
43,60,156,170,144,146,719
0,43,65,65,39,0,212
0,38,60,64,40,0,202
47,71,188,183,154,178,821
48,65,178,180,163,180,814
49,60,158,163,158,169,757
44,65,165,180,152,156,762
49,63,176,191,169,165,813
40,56,147,150,127,118,638
57,71,179,165,149,160,781
46,58,142,158,142,132,678
0,1,2,3,2,0,8
56,74,202,194,163,162,851
24,35,104,98,86,93,440
28,42,119,130,119,124,562
43,58,160,160,136,139,696
47,71,167,179,155,145,764
44,71,195,189,168,185,852
56,118,248,261,229,232,1144
39,49,154,149,137,131,659
44,59,146,147,127,131,654
42,57,141,145,120,114,619
20,27,73,73,59,65,317
41,64,169,179,150,164,767
19,31,73,79,75,66,343
17,23,73,74,60,68,315
37,46,110,114,109,103,519
44,64,163,158,131,150,710
36,49,143,140,126,141,635
35,51,140,149,115,125,615
43,68,180,181,148,161,781
53,73,180,177,167,170,820
47,61,158,153,130,128,677
40,49,140,120,102,122,573
42,57,154,154,120,115,642
39,58,167,165,126,130,685
37,58,136,146,125,133,635
28,38,109,123,106,99,503
43,48,150,147,127,145,660
31,46,124,130,111,128,570
33,46,140,139,126,128,612
44,58,152,159,132,128,673
38,56,147,158,129,132,660
40,49,132,141,109,113,584
13,22,56,52,48,58,249
43,61,152,159,132,141,688
40,49,137,128,113,110,577
24,38,104,108,98,91,463
50,65,182,188,164,162,811
29,37,95,105,91,93,450
42,58,158,166,140,163,727
46,72,166,164,136,149,733
43,58,144,152,127,130,654
33,42,106,118,103,99,501
25,40,92,95,90,85,427
24,34,105,107,84,95,449
24,39,92,82,69,70,376
21,36,85,89,79,82,392
24,32,83,88,79,84,390
24,27,84,90,85,81,391
24,27,84,90,85,81,391
21,36,90,94,74,81,396
25,32,69,66,68,64,324
21,30,76,77,63,68,335
3,2,4,4,2,4,19
21,20,55,67,63,49,275
21,35,81,84,67,60,348
41,51,145,152,132,131,652
1,2,1,2,3,3,12
30,46,121,105,88,96,486
28,40,98,94,83,85,428
27,40,99,111,94,88,459
25,38,91,94,78,66,392
19,20,63,68,66,67,303
38,55,153,160,133,140,679
27,41,112,117,97,116,510
37,47,137,128,113,114,576
26,44,107,100,96,110,483
17,26,68,61,48,48,268
28,46,105,116,102,101,498
17,18,58,70,60,68,291
0,1,2,1,2,1,7
11,22,50,48,35,46,212
24,27,70,75,62,59,317
47,60,167,179,155,160,768
44,65,175,165,144,168,761
45,56,156,162,133,148,700
24,33,78,88,72,66,361
13,23,68,63,53,53,273
13,23,68,63,53,53,273
51,81,197,205,171,175,880
43,66,176,193,172,171,821
49,64,189,191,162,149,804
49,66,186,202,167,149,819
42,60,160,178,157,154,751
40,64,178,166,145,154,747
50,70,182,192,162,167,823
55,70,187,177,163,163,815
49,64,183,189,168,165,818
34,43,119,106,91,100,493
42,64,167,171,163,168,775
34,51,129,139,116,114,583
39,55,144,141,135,124,638
47,51,152,148,139,140,677
20,34,86,90,74,68,372
35,53,133,144,130,146,641
46,62,178,176,140,151,753
29,45,118,115,101,119,527
34,52,132,122,108,114,562
30,41,114,120,106,114,525
30,41,114,120,106,114,525
38,54,147,147,120,128,634
41,62,155,149,128,129,664
22,32,92,94,89,88,417
26,26,79,86,66,72,355
36,57,151,140,124,128,636
49,59,161,161,133,149,712
44,55,155,150,142,151,697
43,57,146,154,134,128,662
52,71,194,200,165,173,855
49,59,180,171,140,153,752
26,35,85,100,87,79,412
26,38,104,104,93,107,472
51,66,181,174,154,165,791
50,61,181,186,161,168,807
27,37,89,92,97,100,442
32,33,113,112,113,115,518
33,47,123,118,111,125,557
27,43,108,94,87,102,461
51,75,197,194,168,160,845
37,52,155,151,134,127,656
45,64,170,158,130,131,698
40,61,171,189,152,161,774
35,45,104,107,104,111,506
37,46,145,136,106,97,567
41,57,158,179,155,157,747
36,57,136,156,146,134,665
20,33,89,93,83,81,399
38,51,135,134,116,136,610
25,32,89,104,93,89,432
39,58,144,140,123,129,633
36,52,143,146,133,134,644
41,53,139,155,130,130,648
38,61,169,173,148,153,742
37,51,161,154,124,140,667
46,69,178,195,168,161,817
39,77,188,200,170,171,845
46,78,181,185,158,169,817
48,61,176,195,159,157,796
36,52,138,130,111,112,579
46,72,194,184,168,179,843
51,66,186,183,146,159,791
48,63,172,175,149,160,767
42,62,168,165,150,164,751
39,55,154,155,145,159,707
52,72,190,185,163,167,829
49,66,166,165,142,148,736
45,64,150,167,149,165,740
54,68,187,180,160,167,816
45,65,166,165,139,150,730
44,54,146,160,137,152,693
56,67,201,187,159,165,835
51,58,175,172,160,177,793
48,63,162,159,143,153,728
48,63,159,165,152,152,739
33,51,130,133,111,117,575
40,50,141,147,116,130,624
34,48,129,124,110,108,553
45,71,185,182,152,160,795
45,72,172,169,145,164,767
47,65,185,190,164,172,823
40,62,150,155,137,129,673
35,46,125,130,102,93,531
52,67,182,178,171,174,824
55,72,190,182,172,183,854
50,72,199,197,170,169,857
48,57,173,187,162,144,771
48,57,173,187,162,144,771
49,63,170,185,165,143,775
51,66,188,171,154,169,799
51,71,185,177,165,169,818
51,67,189,181,166,162,816
46,74,177,157,133,149,736
51,73,193,194,172,184,867
54,66,194,196,169,173,852
30,41,117,118,109,107,522
55,74,206,198,170,171,874
26,46,112,121,112,116,533
53,77,189,199,178,180,876
57,66,203,193,166,179,864
47,58,181,181,156,163,786
45,58,171,190,151,153,768
37,63,153,157,136,137,683
48,61,187,199,174,184,853
51,71,180,186,170,187,845
59,75,188,185,173,168,848
54,69,189,184,166,164,826
54,63,176,192,170,179,834
24,22,65,54,53,72,290
42,57,167,173,158,169,766
48,71,181,178,158,169,805
53,72,196,183,155,176,835
54,66,195,195,164,161,835
46,67,178,198,172,175,836
50,70,187,187,160,172,826
42,53,167,178,146,172,758
45,62,149,166,157,154,733
47,62,168,175,150,173,775
48,70,171,173,155,151,768
45,61,172,162,159,157,756
48,67,184,182,157,170,808
43,65,155,163,158,160,744
44,65,172,176,161,168,786
39,69,186,195,163,169,821
39,56,142,145,117,129,628
44,66,174,180,153,162,779
49,59,175,171,155,165,774
45,68,185,172,151,158,779
45,69,167,176,161,164,782
35,49,135,142,130,141,632
38,58,139,154,131,133,653
13,19,62,71,50,60,275
50,65,194,189,161,161,820
357,846,1737,1749,1465,1677,7831
34,47,116,120,111,128,556
41,59,145,151,132,121,649
55,66,179,177,160,184,821
37,57,161,166,134,148,703
43,48,141,150,123,145,650
43,60,157,163,147,141,711
45,55,158,166,153,163,740
45,62,150,154,136,153,700
47,60,148,158,145,149,707
42,63,156,163,142,146,712
40,60,158,172,144,152,726
37,57,155,159,140,164,712
47,62,176,171,146,170,772
19,21,74,72,62,57,305
28,43,118,116,112,118,535
30,39,112,117,114,122,534
34,54,124,123,108,110,553
28,40,105,117,99,110,499
31,42,103,115,102,112,505
34,49,122,127,117,120,569
24,37,93,93,87,88,422
52,72,178,184,163,177,826
48,60,174,177,153,168,780
48,72,193,195,171,154,833
43,59,155,163,135,125,680
40,63,173,179,158,170,783
46,69,170,169,156,150,760
30,41,102,106,102,100,481
22,43,113,104,97,75,454
46,63,206,196,162,156,829
51,73,197,187,168,183,859
47,71,184,180,159,166,807
21,33,79,77,72,77,359
49,73,201,201,170,173,867
44,65,195,186,151,167,808
45,58,188,189,162,162,804
49,73,192,190,153,170,827
55,66,192,202,186,165,866
53,66,188,195,181,176,859
47,68,177,183,170,165,810
47,61,184,179,152,147,770
46,61,171,162,150,165,755
428,1179,2427,2411,2069,2385,10899
279,687,1464,1427,1258,1451,6566
46,64,184,188,165,165,812
0,42,60,72,42,0,216
35,61,142,140,122,138,638
0,39,58,62,37,0,196
0,41,71,73,40,0,225
0,38,76,65,33,0,212
0,47,68,76,40,0,231
46,62,181,192,160,154,795
38,54,152,152,125,124,645
52,65,195,188,167,169,836
46,70,187,174,152,163,792
40,55,138,142,125,151,651
54,70,200,192,160,170,846
0,42,62,63,38,0,205
46,62,166,171,156,150,751
43,61,164,169,149,161,747
42,60,152,156,138,144,692
40,53,147,162,141,154,697
51,71,196,200,165,170,853
51,62,183,195,166,164,821
53,64,165,168,154,170,774
51,71,181,174,152,166,795
45,64,154,157,152,157,729
45,63,163,166,138,152,727
43,60,159,154,120,132,668
41,52,140,146,131,127,637
46,60,167,167,148,150,738
45,60,162,170,146,150,733
48,72,184,193,175,184,856
44,58,151,173,169,147,742
43,60,151,173,156,163,746
51,67,189,186,162,170,825
53,69,192,185,158,163,820
50,63,187,195,157,142,794
47,66,196,204,174,172,859
47,66,192,207,179,174,865
52,75,197,201,165,177,867
54,79,196,190,171,185,875
53,68,183,185,160,188,837
53,69,195,196,158,162,833
46,76,192,197,164,170,845
47,71,189,189,159,163,818
0,32,53,62,35,0,182
0,32,53,62,35,0,182
0,41,60,72,40,0,213
47,69,187,196,178,168,845
42,68,186,190,167,159,812
50,68,177,185,162,173,815
45,73,185,191,159,161,814
51,65,185,196,169,163,829
50,69,181,173,163,168,804
50,70,174,186,163,159,802
42,61,156,146,124,140,669
46,60,161,164,145,154,730
43,55,156,166,154,142,716
45,66,177,177,152,166,783
44,65,177,177,152,164,779
49,71,174,183,169,160,806
51,70,178,186,152,173,810
44,69,174,195,176,178,836
46,66,172,175,160,162,781
46,64,175,180,157,163,785
50,69,166,164,149,162,760
44,70,158,164,135,140,711
49,70,175,183,156,164,797
43,62,175,182,157,166,785
52,67,177,180,155,164,795
47,68,172,182,154,166,789
25,34,89,95,73,76,392
37,53,136,145,130,144,645
47,67,180,180,146,165,785
38,46,133,150,131,124,622
37,49,135,134,108,117,580
46,61,144,157,139,137,684
49,78,209,190,156,160,842
48,70,203,199,162,162,844
49,66,170,178,151,171,785
45,65,167,186,157,157,777
50,70,192,181,148,155,796
45,70,193,194,170,174,846
42,67,183,181,154,183,810
33,45,119,113,99,109,518
41,52,127,128,121,108,577
46,73,194,196,169,172,850
39,53,142,138,115,128,615
45,55,146,139,119,143,647
36,45,129,136,124,130,600
0,40,63,64,37,0,204
0,39,62,66,36,0,203
50,73,197,204,174,169,867
50,77,202,205,175,167,876
48,68,188,182,159,162,807
51,71,191,187,156,160,816
51,71,191,187,156,160,816
50,75,188,189,170,170,842
48,74,193,194,170,175,854
44,66,178,193,164,178,823
51,70,187,190,166,163,827
26,39,103,102,91,76,437
57,68,205,201,171,176,878
43,44,155,174,141,143,700
56,72,201,202,166,163,860
25,43,100,106,84,86,444
0,38,58,66,41,0,203
0,38,60,64,35,0,197
48,66,183,202,167,163,829
0,38,60,68,42,0,208
0,40,65,71,47,0,223
34,51,134,141,117,116,593
12,41,86,87,75,52,353
14,41,87,87,75,56,360
35,54,157,179,162,145,732
0,29,63,70,41,0,203
0,37,62,66,38,0,203
53,69,189,199,180,168,858
56,74,188,181,160,169,828
18,35,81,61,54,55,304
46,60,164,181,155,161,767
55,69,183,193,171,147,818
0,43,65,74,43,0,225
0,38,68,75,44,0,225
0,37,65,68,45,0,215
0,37,62,67,42,0,208
0,40,63,66,43,0,212
0,36,59,66,44,0,205
54,74,182,186,178,175,849
0,40,62,65,41,0,208
50,69,187,188,177,181,852
51,77,200,197,176,177,878
46,60,172,182,157,150,767
42,55,152,166,142,149,706
0,32,55,61,37,0,185
48,73,204,194,161,159,839
33,51,129,139,124,130,606
47,67,179,195,165,149,802
48,70,183,190,170,172,833
17,22,62,62,57,51,271
48,74,191,189,162,180,844
51,71,177,180,156,154,789
46,69,167,169,145,158,754
39,61,166,175,148,156,745
32,39,118,114,93,100,496
23,37,104,97,77,82,420
44,62,165,178,154,153,756
49,63,177,183,162,166,800
29,47,116,119,97,92,500
15,26,58,63,49,54,265
29,29,96,90,66,86,396
22,31,79,86,64,72,354
17,26,58,66,50,46,263
0,33,59,68,42,0,202
17,26,58,64,50,43,258
40,57,144,149,129,140,659
16,31,88,92,73,83,383
42,65,158,151,122,125,663
43,61,159,169,158,157,747
1,35,65,78,41,4,224
44,73,229,222,173,159,900
25,52,118,119,102,80,496
1,37,62,74,42,6,222
46,60,177,183,151,171,788
52,73,181,188,162,178,834
0,35,63,69,40,0,207
17,27,55,65,55,48,267
30,38,111,101,78,80,438
40,57,139,143,126,125,630
25,31,87,74,59,69,345
0,33,50,52,31,3,169
55,73,200,194,184,197,903
55,82,192,198,170,165,862
51,71,196,197,171,177,863
20,25,68,64,46,52,275
13,15,52,54,45,55,234
8,18,38,45,32,33,174
13,20,46,53,50,40,222
49,69,186,196,173,180,853
41,68,168,163,152,160,752
15,24,59,43,50,67,258
17,26,63,75,48,52,281
57,71,180,198,164,171,841
34,48,111,118,104,101,516
50,66,193,193,167,182,851
48,68,201,207,172,165,861
13,19,61,70,49,54,266
3,4,5,4,4,3,23
31,46,118,115,103,104,517
29,41,114,117,93,93,487
52,73,194,208,186,173,886
53,73,203,200,172,172,873
50,70,179,183,164,183,829
48,66,168,177,164,169,792
51,62,174,193,171,165,816
15,25,59,56,44,42,241
52,76,194,211,179,174,886
53,73,176,184,163,172,821
57,79,202,197,179,184,898
52,76,206,200,179,176,889
52,69,184,205,167,175,852
51,73,194,207,168,173,866
54,79,202,210,170,179,894
14,20,48,59,49,42,232
53,70,190,189,163,176,841
40,59,159,170,147,140,715
44,60,161,173,150,130,718
45,69,185,178,170,186,833
40,66,164,166,149,157,742
15,24,44,53,38,42,216
46,68,179,197,170,174,834
14,19,52,59,52,42,238
50,77,197,211,168,167,870
47,74,217,216,167,172,893
46,71,184,204,177,169,851
56,71,205,189,165,167,853
10,15,38,48,39,31,181
50,74,197,207,183,184,895
12,17,42,50,38,30,189
14,21,49,52,46,49,231
13,25,49,56,44,44,231
11,21,51,52,42,43,220
13,15,43,46,37,48,202
29,47,126,120,108,127,557
54,71,190,199,171,181,866
31,48,135,148,132,115,609
46,66,159,170,148,148,737
45,67,189,199,183,183,866
53,76,201,201,169,173,873
59,77,210,210,179,174,909
44,75,187,192,169,173,840
52,76,194,207,169,172,870
30,33,95,94,86,93,431
10,18,39,46,35,40,188
46,72,194,219,167,164,862
49,70,196,207,175,192,889
51,70,189,194,169,174,847
43,66,179,195,166,165,814
49,77,186,186,157,156,811
43,71,195,198,168,171,846
12,15,34,35,39,45,180
13,21,46,48,39,36,203
51,72,195,188,168,177,851
11,20,38,43,33,31,176
39,56,152,135,122,148,652
15,21,45,48,40,34,203
12,20,45,49,37,40,203
50,70,202,213,172,174,881
28,32,99,100,85,101,445
48,66,189,189,158,147,797
48,65,180,183,153,158,787
41,65,179,188,158,167,798
52,72,205,184,163,167,843
44,59,153,172,159,163,750
43,62,156,176,169,165,771
27,44,109,121,96,93,490
35,47,135,133,117,121,588
44,62,164,161,134,148,713
39,58,163,181,151,156,748
12,28,53,53,42,42,230
20,29,78,85,73,77,362
23,24,77,76,66,69,335
15,40,110,122,81,71,439
20,53,127,120,76,57,453
55,66,190,185,157,168,821
39,61,173,167,144,153,737
46,61,167,160,147,144,725
9,22,39,38,26,33,167
23,43,123,102,66,59,416
9,20,56,60,44,37,226
25,52,158,153,110,91,589
21,29,90,99,78,83,400
7,9,21,18,12,18,85
31,33,96,98,107,109,474
42,55,160,156,137,133,683
3,3,4,9,8,5,32
45,59,155,154,138,147,698
1,2,0,2,2,0,7
31,47,128,107,105,122,540
0,1,3,5,5,0,14
0,25,44,44,26,0,139
0,32,47,56,37,0,172
34,52,129,140,114,108,577
38,62,160,170,144,147,721
23,35,103,95,84,111,451
25,44,112,120,95,87,483
45,60,177,182,154,169,787
26,34,83,79,73,71,366
23,31,103,106,85,94,442
40,54,146,155,137,136,668
52,75,196,200,174,188,885
17,24,47,56,46,47,237
21,20,65,65,62,54,287
18,25,80,103,94,95,415
48,62,170,177,147,152,756
44,54,165,184,146,140,733
32,46,117,124,116,109,544
41,62,148,146,124,139,660
50,75,189,187,160,183,844
51,68,191,176,150,178,814
38,50,145,152,133,130,648
44,62,162,160,137,151,716
34,44,123,136,118,99,554
36,50,127,128,106,114,561
50,57,175,180,153,154,769
51,66,180,171,148,166,782
50,62,181,181,154,157,785
40,60,156,156,145,148,705
37,56,148,161,142,151,695
49,63,193,189,152,155,801
44,64,180,184,148,156,776
47,67,183,196,167,168,828
51,70,179,190,174,164,828
44,58,152,166,148,139,707
33,53,133,146,127,131,623
37,52,154,164,146,159,712
41,56,143,148,136,145,669
28,36,111,121,107,103,506
44,54,154,165,146,152,715
0,40,64,64,35,0,203
0,41,71,71,39,0,222
0,34,55,66,38,0,193
48,59,172,177,156,159,771
0,37,59,67,43,0,206
0,41,64,69,44,0,218
54,70,182,184,166,170,826
48,60,176,189,165,171,809
8,35,78,70,50,30,271
14,30,80,85,62,47,318
50,69,151,166,162,184,782
30,42,104,107,103,101,487
51,75,213,213,183,178,913
32,45,127,136,114,123,577
14,21,62,70,62,56,285
14,34,95,108,79,56,386
17,25,55,65,53,50,265
14,21,75,73,54,46,283
0,39,53,60,35,0,187
17,22,60,61,54,48,262
14,21,49,63,47,41,235
39,63,158,155,133,136,684
12,30,88,90,59,51,330
19,21,49,56,49,31,225
51,70,187,181,168,166,823
38,52,136,133,110,126,595
18,28,62,53,43,61,265
29,33,83,79,77,91,392
6,7,18,18,19,12,80
30,58,143,140,119,117,607
24,22,68,56,51,75,296
45,69,189,182,150,165,800
36,56,158,175,142,143,710
26,37,98,102,78,86,427
39,61,149,159,143,142,693
27,33,88,95,85,81,409
52,64,178,189,165,179,827
29,37,82,88,81,78,395
32,53,171,158,138,129,681
43,61,158,173,142,146,723
45,63,165,165,149,145,732
37,56,147,160,141,149,690
27,43,111,115,89,106,491
45,55,167,156,145,152,720
22,31,100,103,90,96,442
24,40,104,121,104,92,485
25,33,98,101,89,99,445
44,56,167,168,141,142,718
54,67,199,202,168,170,860
44,62,180,185,161,149,781
39,62,155,168,137,158,719
43,77,205,201,171,185,882
57,68,187,185,164,164,825
47,66,186,194,160,170,823
53,74,183,178,156,158,802
52,69,174,172,153,148,768
49,69,177,172,150,149,766
37,55,150,147,125,140,654
42,61,160,159,138,147,707
55,77,196,205,172,171,876
52,71,185,203,158,160,829
0,39,66,65,39,0,209
18,56,130,134,92,57,487
36,56,147,158,135,140,672
32,48,131,156,139,135,641
32,48,131,156,139,135,641
23,28,65,57,57,37,267
47,69,168,177,164,157,782
27,36,105,89,72,93,422
43,50,140,130,111,121,595
0,43,62,71,42,0,218
48,72,189,183,165,164,821
41,63,165,162,139,151,721
47,66,177,193,173,180,836
55,80,210,196,161,193,895
45,68,177,181,156,167,794
49,76,195,200,177,181,878
48,68,190,182,151,162,801
22,26,70,64,60,59,301
12,16,58,69,49,53,257
20,24,77,79,64,75,339
51,73,171,172,155,155,777
32,38,118,134,109,93,524
22,20,78,76,57,59,312
17,27,60,69,65,67,305
26,26,79,72,71,67,341
47,67,177,183,158,184,816
47,63,171,182,158,157,778
48,64,180,181,145,158,776
24,31,88,86,87,98,414
43,56,171,171,128,137,706
54,75,187,189,159,169,833
47,70,197,203,176,169,862
40,60,156,156,145,148,705
36,42,131,142,125,104,580
37,45,125,116,98,112,533
42,58,155,157,132,149,693
36,61,159,173,140,151,720
57,72,190,194,168,161,842
15,25,53,59,50,52,254
16,25,55,58,52,42,248
36,51,125,133,121,118,584
46,64,148,163,139,150,710
50,71,185,196,158,164,824
45,61,169,153,121,135,684
32,53,134,148,118,121,606
39,45,151,158,141,146,680
35,61,156,155,134,144,685
40,58,165,149,126,140,678
19,24,62,69,51,51,276
35,53,136,143,125,123,615
41,56,147,139,106,123,612
15,20,51,65,53,45,249
35,56,149,159,148,152,699
0,1,6,11,6,3,27
47,70,177,185,172,176,827
11,16,46,56,30,39,198
37,48,127,132,118,123,585
42,49,139,139,120,120,609
33,44,125,129,112,117,560
41,62,156,150,131,138,678
41,62,156,150,131,138,678
23,34,84,98,70,73,382
31,47,141,152,130,146,647
34,42,131,145,123,121,596
46,61,169,159,120,131,686
32,41,108,127,119,110,537
24,44,119,128,97,105,517
16,34,83,89,69,68,359
47,62,163,170,149,153,744
36,64,159,157,128,135,679
21,26,59,52,41,47,246
17,20,60,65,69,65,296
20,22,79,87,81,79,368
27,38,96,85,78,86,410
54,71,188,188,166,166,833
42,68,161,171,166,155,763
45,64,169,176,162,155,771
38,50,139,141,123,127,618
13,27,85,103,66,42,336
44,65,179,173,144,147,752
47,71,174,175,149,165,781
24,37,100,111,98,101,471
36,45,124,131,115,114,565
48,68,186,190,163,177,832
14,25,78,79,67,69,332
25,37,92,86,64,81,385
25,38,98,91,78,79,409
3,3,3,8,9,13,39
39,59,166,167,141,145,717
30,40,91,100,94,103,458
31,47,104,108,106,110,506
33,46,106,106,101,96,488
4,4,2,4,5,4,23
9,6,11,8,9,14,57
29,51,127,140,122,130,599
2,1,3,6,2,6,20
51,69,177,187,158,162,804
42,62,178,173,157,155,767
15,17,43,51,38,33,197
5,4,4,4,5,2,24
3,4,8,8,6,7,36
3,4,2,3,3,6,21
26,39,79,85,74,78,381
51,50,166,162,145,135,709
19,22,83,77,56,60,317
16,32,81,67,49,62,307
37,40,96,92,85,95,445
52,73,188,184,154,167,818
41,57,151,165,125,126,665
50,76,188,196,171,169,850
21,26,82,87,75,67,358
16,21,64,79,65,56,301
21,30,71,75,62,64,323
19,21,49,56,49,31,225
21,30,88,99,91,87,416
11,18,55,60,45,52,241
29,46,123,119,90,98,505
3,4,6,6,4,9,32
14,30,70,64,57,64,299
6,6,10,9,6,7,44
18,29,90,98,77,82,394
29,30,89,98,95,99,440
25,37,92,94,93,77,418
25,18,64,83,62,69,321
23,30,91,108,93,108,453
43,54,145,147,129,143,661
0,1,1,1,5,9,17
19,26,54,64,51,47,261
7,6,15,16,18,19,81
35,53,141,142,107,112,590
46,64,183,172,154,151,770
41,57,148,143,113,131,633
47,66,183,189,156,157,798
20,35,85,76,70,83,369
54,74,190,200,170,175,863
50,68,183,183,164,188,836
47,68,199,203,178,172,867
52,76,206,179,149,167,829
15,42,122,112,82,71,444
11,16,53,77,63,60,280
54,80,201,196,171,179,881
33,59,146,155,143,138,674
