50,76,191,201,157,163,838
18,20,75,87,65,61,326
10,16,26,26,23,28,129
26,37,77,78,69,71,358
59,77,206,193,166,177,878
8,17,36,42,32,36,171
41,60,148,155,138,148,690
23,31,68,59,63,70,314
20,28,60,69,69,76,322
50,67,183,192,166,162,820
15,31,93,97,81,85,402
13,25,70,62,52,53,275
21,20,73,79,72,84,349
22,23,80,99,89,71,384
9,11,21,16,19,27,103
17,22,63,56,45,54,257
14,15,35,41,31,30,166
21,36,74,79,66,74,350
16,28,64,57,39,44,248
18,18,58,45,43,51,233
13,21,60,67,64,55,280
22,24,77,70,61,63,317
38,56,131,147,127,133,632
23,29,82,89,68,71,362
45,63,181,186,165,176,816
21,34,75,78,72,64,344
26,36,100,88,95,71,416
20,37,86,85,90,84,402
47,66,180,187,156,146,782
15,19,45,35,29,26,169
17,18,55,51,56,67,264
42,63,169,172,141,165,752
24,32,95,108,100,80,439
25,31,96,100,92,66,410
46,62,174,187,160,185,814
37,56,140,143,132,141,649
15,44,85,85,61,47,337
17,29,58,60,55,54,273
20,48,110,108,68,50,404
20,56,117,110,82,62,447
41,58,155,166,136,126,682
40,50,141,154,135,130,650
53,66,179,194,160,154,806
50,63,174,168,150,164,769
20,75,113,93,63,48,412
25,31,92,101,73,77,399
22,35,90,88,72,75,382
27,42,98,109,91,105,472
42,62,178,182,150,156,770
3,16,18,15,20,22,94
25,34,71,91,71,74,366
6,8,15,22,19,15,85
33,53,142,146,128,157,659
24,33,77,80,70,67,351
16,23,71,75,58,74,317
18,31,62,72,67,66,316
24,29,70,79,82,85,369
7,10,9,9,2,4,41
17,46,97,87,68,43,358
8,12,19,32,29,26,126
19,31,84,91,82,69,376
20,29,53,69,69,66,306
17,29,70,69,62,78,325
35,57,155,149,132,139,667
14,56,111,94,72,73,420
16,31,60,57,54,63,281
15,20,66,68,48,63,280
22,29,68,72,59,54,304
47,57,172,194,170,175,815
28,34,104,108,89,97,460
28,34,90,99,79,97,427
43,60,168,170,148,160,749
45,55,183,203,171,165,822
55,62,172,197,174,167,827
25,31,84,94,81,73,388
10,13,55,48,44,33,203
27,38,110,126,105,99,505
25,28,68,83,69,76,349
38,51,126,129,105,108,557
23,32,95,96,75,78,399
18,65,126,116,77,60,462
43,53,137,146,126,149,654
42,52,157,163,126,138,678
29,36,77,76,66,69,353
42,60,160,159,135,140,696
15,54,98,98,72,51,388
20,57,115,91,63,58,404
16,56,109,103,68,49,401
39,55,155,156,134,146,685
14,20,61,63,49,58,265
27,53,108,107,93,103,491
24,30,82,89,80,68,373
37,49,134,137,122,120,599
30,34,101,115,82,75,437
45,64,152,159,141,139,700
47,65,188,189,169,181,839
21,37,82,71,60,70,341
11,28,76,79,47,32,273
9,11,14,12,10,15,71
42,45,105,104,92,96,484
45,66,172,177,159,153,772
30,39,111,113,100,102,495
48,65,180,187,156,153,789
29,45,104,110,85,108,481
27,32,88,98,83,87,415
44,53,155,168,146,147,713
6,14,42,40,36,33,171
13,48,92,78,49,43,323
9,17,28,30,25,25,134
31,43,99,108,90,91,462
12,41,79,78,58,48,316
48,70,174,168,141,145,746
22,36,85,89,70,64,366
20,58,128,127,85,61,479
28,38,111,126,104,98,505
14,61,109,94,67,58,403
19,29,64,60,64,81,317
26,36,89,93,68,79,391
22,36,78,81,72,83,372
44,62,181,188,155,156,786
23,25,57,66,60,53,284
20,61,126,135,97,70,509
5,15,37,55,38,22,172
15,24,58,46,54,65,262
37,59,131,137,118,134,616
45,65,180,183,155,157,785
39,52,147,160,148,147,693
25,33,99,109,85,88,439
43,60,185,199,173,171,831
15,74,131,110,77,56,463
5,31,57,53,31,27,204
18,64,112,94,73,51,412
13,56,99,99,59,55,381
35,54,131,147,123,131,621
19,35,88,115,87,102,446
35,60,151,148,124,150,668
51,63,177,185,161,168,805
18,35,78,92,71,71,365
21,70,142,129,92,70,524
14,25,51,62,49,41,242
43,64,174,176,152,151,760
23,36,64,68,62,56,309
7,20,38,39,31,30,165
8,10,25,38,29,24,134
13,20,56,55,47,53,244
15,26,59,56,40,30,226
23,32,87,101,78,73,394
24,44,106,108,97,100,479
20,31,79,76,72,71,349
40,61,181,177,154,160,773
32,45,107,105,82,89,460
36,62,153,151,130,148,680
13,52,103,80,56,51,355
18,30,94,104,84,82,412
19,26,49,53,46,41,234
28,31,91,103,97,94,444
42,68,187,189,160,179,825
35,47,133,146,124,133,618
14,41,84,86,68,46,339
15,23,59,72,48,60,277
18,23,59,64,47,58,269
43,65,163,163,134,156,724
20,56,114,99,70,57,416
22,65,129,122,81,62,481
20,30,80,83,80,66,359
13,26,44,41,40,32,196
8,11,8,9,8,9,53
22,40,94,102,85,109,452
22,26,80,86,83,90,387
45,64,180,187,161,162,799
14,24,50,50,44,44,226
13,46,91,80,56,46,332
37,58,185,191,160,159,790
3,7,10,11,7,8,46
15,19,49,40,40,49,212
38,63,157,161,129,139,687
17,22,65,66,47,55,272
19,26,76,83,78,77,359
37,55,159,164,138,155,708
17,28,64,58,48,41,256
39,45,143,140,114,107,588
21,32,76,86,85,66,366
7,10,13,12,7,5,54
18,63,114,111,81,57,444
14,22,70,67,54,67,294
21,34,86,84,68,73,366
43,66,163,186,172,153,783
47,61,178,179,157,162,784
40,60,156,167,150,142,715
1,1,2,10,9,4,27
10,19,48,49,55,62,243
32,39,108,109,91,97,476
16,24,43,48,51,37,219
47,65,188,192,159,170,821
31,32,88,96,87,90,424
24,35,89,86,71,77,382
19,75,135,114,78,60,481
20,57,114,91,64,61,407
19,68,117,99,72,48,423
18,65,133,128,81,62,487
6,19,26,33,23,28,135
9,23,43,36,22,35,168
29,45,98,109,98,96,475
20,32,76,84,78,75,365
9,11,26,26,17,20,109
3,5,13,19,20,9,69
21,70,138,118,82,61,490
19,33,80,89,76,79,376
16,21,49,52,41,52,231
46,61,166,168,142,144,727
37,48,131,150,130,155,651
17,22,69,68,48,50,274
10,35,85,71,45,58,304
23,29,88,104,80,83,407
19,62,124,126,95,77,503
17,56,124,109,78,69,453
14,21,66,68,63,69,301
47,64,181,184,165,168,809
21,29,74,75,63,46,308
46,63,182,186,164,168,809
48,65,178,181,153,155,780
22,39,100,105,82,91,439
24,38,89,95,85,90,421
12,54,96,82,54,44,342
25,35,98,102,82,85,427
24,40,102,106,94,96,462
24,40,82,90,86,104,426
36,55,142,126,109,120,588
7,12,16,29,28,25,117
20,25,49,59,59,72,284
19,30,67,63,62,64,305
15,17,47,54,52,61,246
26,46,103,104,80,99,458
29,38,88,102,74,77,408
7,10,18,22,22,19,98
35,52,129,133,116,127,592
45,58,160,177,152,160,752
43,71,179,179,153,166,791
43,57,158,165,146,150,719
16,52,103,104,68,48,391
13,21,46,48,29,35,192
10,8,26,24,18,16,102
21,26,76,80,79,68,350
10,50,81,72,44,25,282
19,29,76,79,72,72,347
15,55,111,102,70,46,399
11,24,59,52,48,51,245
23,30,93,101,85,89,421
26,40,89,79,69,96,399
6,13,15,21,23,18,96
37,51,131,139,126,118,602
42,59,141,156,129,130,657
16,61,118,120,91,64,470
41,57,176,196,167,159,796
9,25,45,32,25,23,159
19,38,86,83,73,88,387
26,49,93,95,77,81,421
1,2,3,7,9,10,32
15,49,99,91,76,60,390
26,42,107,105,89,102,471
6,11,16,18,21,15,87
33,43,99,116,109,111,511
52,61,179,186,165,160,803
12,44,85,80,59,37,317
28,34,100,115,103,112,492
31,36,104,117,86,76,450
24,34,80,78,71,82,369
28,45,117,114,93,110,507
42,52,133,137,131,135,630
19,67,127,128,94,56,491
30,50,110,112,89,90,481
45,61,174,189,163,174,806
42,59,164,176,155,154,750
43,53,148,155,125,133,657
31,33,87,94,96,88,429
1,3,16,19,19,13,71
18,61,123,123,93,76,494
17,57,134,134,83,69,494
31,42,111,114,92,103,493
24,43,100,104,83,95,449
22,29,94,100,87,93,425
14,42,82,81,75,58,352
52,67,180,198,174,165,836
24,34,80,89,92,75,394
13,48,110,103,70,44,388
9,37,50,36,28,37,197
43,63,175,180,152,144,757
12,13,27,29,31,31,143
34,55,134,145,127,123,618
40,58,161,163,137,157,716
24,27,66,65,53,60,295
10,19,65,63,55,44,256
29,45,111,123,118,112,538
24,36,93,101,101,92,447
17,20,57,55,40,53,242
39,55,138,140,127,141,640
17,50,104,107,73,55,406
26,35,105,110,93,100,469
10,8,29,39,32,27,145
36,52,132,114,96,101,531
9,15,28,34,25,31,142
16,28,66,63,57,47,277
44,63,151,144,126,137,665
38,57,163,175,136,143,712
35,52,129,129,112,127,584
14,34,55,47,47,43,240
18,59,114,89,66,44,390
35,42,114,123,103,101,518
3,6,8,8,8,6,39
7,15,44,45,47,48,206
19,33,91,78,69,72,362
34,51,127,140,131,120,603
23,26,84,95,77,76,381
49,71,168,174,154,142,758
28,36,104,106,95,107,476
21,61,132,112,90,73,489
39,52,136,139,116,135,617
38,61,172,182,170,161,784
14,51,97,106,65,53,386
25,38,83,89,77,74,386
47,63,175,194,167,164,810
35,45,112,125,106,113,536
25,30,81,99,86,76,397
44,57,167,181,157,155,761
47,65,184,193,170,177,836
53,61,186,191,152,157,800
19,31,78,92,83,85,388
8,18,35,39,35,34,169
44,61,141,140,123,132,641
34,49,130,116,94,93,516
38,51,133,160,138,142,662
6,6,6,5,7,11,41
25,40,99,109,83,86,442
25,26,74,83,75,71,354
35,49,134,149,133,143,643
18,62,126,126,84,56,472
7,15,25,29,24,29,129
10,39,77,80,65,47,318
14,61,117,106,79,63,440
42,64,164,158,126,138,692
20,39,83,96,86,86,410
33,52,140,148,138,137,648
18,36,101,94,92,83,424
22,31,75,81,71,77,357
18,32,70,62,56,68,306
10,17,55,65,66,61,274
44,57,168,181,157,155,762
51,59,169,192,164,177,812
1,4,2,2,4,6,19
39,65,160,168,155,161,748
22,56,114,108,91,58,449
46,60,164,169,139,143,721
35,44,124,122,95,92,512
25,37,82,77,61,82,364
13,32,56,61,47,36,245
4,7,4,6,4,1,26
15,25,59,67,50,62,278
5,12,16,18,22,14,87
14,21,61,79,58,66,299
16,33,81,77,61,50,318
12,34,67,78,56,53,300
22,31,64,56,57,56,286
21,26,77,90,87,76,377
30,29,102,93,88,86,428
23,30,90,114,88,83,428
16,33,79,70,50,64,312
22,37,81,87,83,75,385
19,35,76,78,58,67,333
25,40,78,79,78,84,384
2,4,7,5,5,8,31
0,2,5,11,10,10,38
4,6,10,10,7,4,41
21,37,87,91,89,73,398
27,33,65,76,71,86,358
45,66,176,178,149,166,780
18,21,72,84,77,71,343
8,24,55,58,42,48,235
6,11,31,40,37,26,151
35,48,142,151,128,143,647
47,61,165,168,150,143,734
12,25,52,68,52,36,245
36,50,142,131,113,125,597
39,49,146,147,122,150,653
40,57,163,169,151,153,733
13,48,93,81,65,46,346
39,58,158,161,129,150,695
42,56,148,160,132,130,668
5,6,1,5,4,3,24
36,62,145,156,136,143,678
3,5,9,12,14,11,54
40,44,127,142,111,117,581
38,52,149,141,120,132,632
26,31,69,73,77,70,346
20,37,86,83,89,85,400
25,40,107,111,99,107,489
11,46,93,79,53,53,335
42,55,150,157,134,143,681
11,19,43,48,37,39,197
43,57,161,144,132,136,673
8,20,45,50,35,37,195
47,67,166,164,143,135,722
38,51,139,147,130,130,635
10,17,39,51,47,46,210
30,43,92,88,95,91,439
40,56,133,130,114,126,599
20,32,67,81,74,80,354
33,55,138,137,116,130,609
15,56,108,103,73,46,401
35,56,146,149,124,133,643
43,61,163,165,130,156,718
17,22,72,68,58,85,322
34,49,125,132,121,133,594
40,56,136,142,120,125,619
33,47,114,117,95,98,504
1,1,3,8,4,0,17
7,41,89,83,63,52,335
18,60,109,103,75,53,418
7,15,43,44,46,42,197
1,2,6,14,10,6,39
18,25,53,48,38,59,241
28,45,118,124,110,117,542
15,43,93,102,67,56,376
1,6,12,17,10,8,54
4,14,18,19,14,14,83
2,2,1,2,2,4,13
13,56,110,106,70,46,401
44,70,183,196,161,158,812
18,31,90,82,66,75,362
32,30,95,94,77,91,419
6,16,35,40,35,30,162
37,56,158,177,151,162,741
18,55,101,79,65,62,380
19,51,101,90,62,54,377
15,23,50,60,57,49,254
43,64,168,170,148,156,749
1,4,6,3,2,10,26
45,50,140,141,112,140,628
2,4,9,9,10,9,43
47,62,183,176,139,162,769
31,32,86,102,79,67,397
3,4,5,8,8,6,34
34,51,136,139,119,126,605
9,28,63,60,36,41,237
23,31,74,65,54,58,305
46,63,172,178,160,170,789
9,20,45,56,43,30,203
21,31,63,72,76,70,333
28,35,86,99,80,81,409
46,73,186,181,145,157,788
1,1,1,4,5,1,13
17,54,110,81,58,59,379
7,17,39,58,33,28,182
25,35,96,102,72,76,406
7,14,24,36,24,23,128
11,12,36,31,24,35,149
36,49,139,148,131,116,619
44,64,171,179,152,150,760
2,3,4,5,4,5,23
14,52,104,110,62,39,381
39,44,119,140,108,113,563
36,61,165,173,136,144,715
46,68,179,188,162,160,803
17,46,97,89,66,58,373
2,3,6,8,8,9,36
9,26,53,52,42,31,213
46,62,161,180,155,164,768
15,34,81,93,69,40,332
1,2,8,14,5,7,37
8,11,9,8,5,4,45
26,38,115,130,106,96,511
43,64,177,179,148,161,772
39,53,131,113,105,113,554
51,71,187,199,172,161,841
31,47,130,137,113,107,565
39,56,151,154,137,149,686
39,50,148,146,122,149,654
35,52,141,153,133,144,658
35,47,115,116,105,103,521
28,25,70,80,73,85,361
17,55,109,101,81,56,419
48,66,166,165,137,156,738
17,22,60,59,53,61,272
31,52,133,128,118,140,602
37,56,158,178,151,161,741
6,11,21,16,14,13,81
19,27,68,75,70,68,327
4,11,23,23,18,14,93
32,52,152,163,140,144,683
19,64,125,124,97,70,499
3,5,3,4,2,2,19
36,54,143,159,133,142,667
11,55,109,93,59,52,379
47,63,187,196,151,157,801
2,3,4,9,6,3,27
34,45,109,106,90,93,477
31,37,103,120,98,98,487
46,68,166,164,137,157,738
13,15,30,31,29,25,143
25,29,78,84,77,70,363
37,54,144,142,110,124,611
45,64,173,189,152,165,788
30,41,89,84,75,78,397
34,48,135,155,128,140,640
1,6,9,7,12,7,42
35,52,157,157,133,143,677
35,53,158,145,123,118,632
45,67,165,164,151,159,751
1,1,1,3,4,1,11
44,67,180,184,153,165,793
44,63,187,195,173,157,819
36,56,149,163,140,155,699
40,61,172,177,139,159,748
2,4,1,2,3,6,18
1,2,3,7,7,3,23
7,23,54,59,42,31,216
11,14,39,45,40,41,190
27,41,123,138,109,100,538
37,60,166,173,144,149,729
3,4,4,6,5,0,22
40,69,157,160,129,149,704
13,47,101,106,70,55,392
41,62,174,174,142,170,763
27,36,102,118,99,96,478
37,60,145,158,137,145,682
4,5,10,8,3,4,34
46,60,182,177,137,154,756
2,13,15,16,14,15,75
17,63,136,109,78,58,461
37,58,145,152,134,144,670
21,36,78,78,82,75,370
40,53,142,146,116,131,628
32,39,85,93,80,87,416
37,65,182,184,159,157,784
5,5,20,30,23,22,105
34,44,118,138,112,105,551
20,29,80,87,78,78,372
21,23,84,96,75,70,369
37,52,130,139,114,120,592
13,36,66,65,55,40,275
30,54,134,153,130,137,638
43,64,176,192,159,171,805
12,31,69,72,56,46,286
37,58,162,173,147,151,728
24,40,95,119,91,97,466
32,42,117,132,103,106,532
6,9,14,15,15,11,70
44,64,158,160,140,130,696
7,45,100,97,78,56,383
25,37,102,95,87,97,443
16,49,102,96,71,53,387
1,6,10,7,12,12,48
41,64,157,160,143,161,726
40,65,156,154,126,138,679
2,1,2,4,3,0,12
25,39,71,70,66,64,335
19,28,77,70,64,86,344
24,35,78,85,68,68,358
13,54,125,121,79,68,460
10,21,54,63,48,38,234
7,15,48,46,34,28,178
20,60,133,138,99,82,532
15,26,73,79,80,79,352
26,90,197,198,120,97,728
0,0,1,4,4,0,9
2,4,3,4,3,1,17
23,45,119,121,98,95,501
25,67,134,149,98,82,555
22,76,166,148,97,73,582
29,43,120,107,91,97,487
31,49,104,101,94,103,482
26,36,79,75,60,68,344
21,65,124,131,96,63,500
7,19,49,54,32,33,194
6,7,6,9,7,8,43
8,19,49,64,49,32,221
1,0,2,4,2,4,13
9,15,42,39,33,34,172
16,69,134,106,94,72,491
21,89,177,163,122,94,666
26,36,90,95,61,50,358
21,68,152,132,87,76,536
16,44,97,92,70,38,357
14,19,40,50,37,35,195
2,6,6,4,2,5,25
7,18,48,47,32,29,181
23,34,74,89,74,62,356
25,41,103,87,73,90,419
1,9,17,21,14,12,74
3,7,6,7,6,11,40
24,37,102,116,94,84,457
19,35,71,68,69,84,346
24,37,82,106,89,93,431
5,15,45,51,36,31,183
12,59,131,114,88,68,472
22,34,91,84,66,67,364
16,50,102,89,63,46,366
29,86,170,166,126,96,673
5,6,2,9,9,0,31
20,40,90,94,64,63,371
2,1,5,2,2,2,14
29,84,171,169,126,98,677
2,5,14,7,6,9,43
23,69,146,149,99,74,560
22,31,79,93,95,79,399
7,22,54,66,43,32,224
12,49,109,106,68,40,384
21,66,135,132,97,79,530
26,86,187,160,127,93,679
16,33,71,73,61,50,304
1,1,2,2,1,0,7
29,41,110,102,90,94,466
20,27,78,89,73,70,357
7,19,47,56,41,36,206
21,30,90,101,90,84,416
16,19,53,72,71,68,299
21,36,97,98,89,95,436
30,39,113,101,88,103,474
25,88,179,172,109,85,658
8,43,88,77,52,39,307
25,41,89,91,85,83,414
15,57,114,113,66,40,405
16,28,82,80,72,87,365
26,81,175,164,110,89,645
24,38,93,103,90,95,443
10,23,61,66,50,56,266
20,27,77,83,65,76,348
8,16,29,31,30,34,148
9,22,52,65,41,36,225
10,6,24,31,25,25,121
6,7,6,6,6,11,42
13,31,66,73,65,67,315
27,97,207,191,125,94,741
16,54,109,99,73,53,404
8,13,39,48,30,24,162
3,4,1,3,2,2,15
24,90,191,179,123,77,684
5,7,8,8,7,5,40
2,2,3,4,5,4,20
13,44,93,89,57,42,338
9,21,55,59,41,32,217
25,80,173,165,107,86,636
9,9,17,12,8,7,62
16,56,122,106,74,54,428
20,69,134,131,99,80,533
23,35,92,99,82,96,427
19,53,124,115,70,48,429
18,32,72,65,59,74,320
10,17,51,47,39,31,195
25,83,181,171,127,99,686
29,40,117,134,108,114,542
3,5,2,1,1,2,14
0,1,4,5,4,2,16
12,54,114,98,71,54,403
27,41,86,83,68,60,365
20,34,81,88,70,68,361
31,42,110,115,104,104,506
3,5,3,1,3,2,17
10,22,47,49,35,35,198
24,37,78,79,68,83,369
17,52,118,106,70,65,428
8,20,46,29,28,25,156
5,16,46,41,23,17,148
24,75,159,150,101,81,590
5,6,5,6,4,10,36
1,2,1,1,1,2,8
23,77,155,155,114,95,619
19,29,74,90,69,68,349
3,5,1,4,6,3,22
33,40,102,122,106,106,509
30,88,185,188,131,99,721
25,39,96,100,81,91,432
4,5,1,1,1,0,12
4,2,4,6,4,6,26
2,5,6,6,3,1,23
9,32,53,44,42,35,215
12,11,35,30,23,28,139
16,50,111,89,60,61,387
2,1,1,0,1,1,6
25,74,158,144,97,69,567
7,20,53,40,29,19,168
8,21,41,37,29,30,166
9,17,38,46,31,29,170
2,3,4,3,0,0,12
21,41,104,105,95,97,463
4,7,6,6,4,9,36
7,12,37,29,19,20,124
18,41,81,79,68,46,333
19,26,65,69,64,74,317
8,10,12,16,11,14,71
12,12,27,23,21,22,117
30,44,109,94,86,81,444
4,4,1,1,1,0,11
1,2,5,3,2,10,23
25,72,163,151,115,92,618
30,43,116,121,110,119,539
3,7,6,7,6,10,39
23,31,95,93,87,85,414
23,77,164,149,110,90,613
26,30,90,111,89,84,430
2,2,2,3,5,4,18
20,31,72,63,67,77,330
9,18,45,41,31,33,177
20,72,160,145,102,74,573
2,14,45,43,26,17,147
20,74,157,135,101,84,571
8,20,51,53,33,39,204
10,29,56,67,42,42,246
20,72,152,143,98,89,574
12,55,114,94,66,53,394
32,91,188,168,124,100,703
9,24,55,62,37,33,220
19,17,59,58,42,53,248
20,32,78,73,61,52,316
11,45,77,75,67,39,314
26,89,171,144,112,92,634
1,6,9,6,3,6,31
13,13,55,49,40,46,216
26,39,113,104,87,91,460
20,27,78,92,75,67,359
32,53,157,167,138,138,685
15,17,47,52,47,62,240
46,68,163,167,140,152,736
5,7,4,4,4,4,28
8,13,27,21,15,23,107
7,11,36,38,35,39,166
30,37,111,107,82,103,470
32,36,97,99,90,86,440
26,38,85,83,65,77,374
28,30,90,102,85,98,433
39,60,155,169,139,140,702
27,41,89,102,102,97,458
28,38,103,118,105,120,512
29,39,116,118,91,83,476
27,32,87,100,79,76,401
5,7,6,6,7,13,44
40,70,165,167,143,149,734
33,40,101,109,94,98,475
32,70,163,157,130,144,696
3,3,3,6,3,4,22
20,31,65,71,73,71,331
18,37,82,89,81,90,397
34,45,116,112,101,101,509
11,20,43,51,57,64,246
21,35,93,92,86,77,404
37,60,147,145,137,136,662
40,44,143,148,124,134,633
38,57,158,165,127,122,667
35,38,120,115,87,105,500
37,54,154,158,132,156,691
46,57,155,163,140,149,710
35,54,142,139,118,121,609
51,61,152,146,124,142,676
29,92,198,175,117,105,716
0,0,1,2,1,1,5
37,48,129,132,105,107,558
22,26,68,80,67,80,343
3,3,1,6,5,2,20
28,97,201,179,126,102,733
36,50,149,150,121,123,629
35,42,112,131,120,115,555
15,11,44,52,48,43,213
43,59,165,175,139,151,732
38,53,145,140,120,126,622
30,44,133,128,106,119,560
10,10,14,17,18,27,96
33,47,129,142,130,128,609
24,40,90,96,85,74,409
24,38,97,99,84,97,439
6,12,11,12,5,5,51
20,31,96,95,71,75,388
29,51,112,128,114,139,573
41,57,154,146,124,130,652
36,46,136,138,119,121,596
10,9,26,36,28,29,138
42,58,150,148,122,136,656
4,7,5,1,2,8,27
51,61,164,163,133,142,714
37,39,114,119,99,104,512
31,35,107,123,102,111,509
36,51,140,136,115,115,593
45,60,180,181,148,152,766
27,33,96,107,83,87,433
14,30,57,59,59,61,280
7,10,17,14,13,23,84
1,5,6,5,3,5,25
41,53,147,159,146,140,686
1,2,1,2,3,3,12
39,58,153,148,123,116,637
17,28,74,75,72,68,334
26,47,120,125,114,110,542
31,40,129,131,113,123,567
21,27,75,72,73,60,328
36,49,123,131,123,122,584
31,41,122,125,95,104,518
12,21,41,38,39,40,191
24,37,97,93,81,93,425
0,0,3,3,1,4,11
37,58,150,140,119,130,634
36,58,154,159,141,153,701
44,63,153,154,140,150,704
25,45,138,138,117,125,588
28,38,102,101,78,99,446
32,46,115,126,107,113,539
11,20,51,43,43,52,220
34,45,129,129,111,115,563
39,50,148,138,115,121,611
4,12,20,18,18,21,93
25,86,190,179,122,108,710
14,23,58,46,50,50,241
36,54,156,150,130,139,665
42,68,167,188,158,160,783
5,3,6,4,3,7,28
11,20,54,63,56,51,255
23,35,109,103,76,89,435
3,4,4,1,1,5,18
5,5,5,5,5,8,33
26,36,120,118,88,91,479
41,62,156,151,126,129,665
39,61,165,161,137,155,718
37,53,147,150,131,136,654
27,50,120,124,114,106,541
29,44,137,147,116,120,593
26,48,121,125,114,110,544
18,28,65,73,63,63,310
35,43,142,126,113,134,593
29,37,102,110,101,112,491
6,7,4,5,3,5,30
30,48,141,137,115,131,602
46,57,157,146,131,148,685
44,61,163,158,129,142,697
24,40,110,127,95,95,491
30,42,121,128,105,100,526
14,25,54,52,57,59,261
7,7,31,25,20,10,100
23,35,95,99,99,114,465
25,33,83,79,75,77,372
31,54,150,155,108,120,618
31,33,112,131,112,104,523
46,66,175,176,138,162,763
28,38,96,90,80,88,420
43,57,147,165,128,142,682
38,48,118,134,112,109,559
1,3,3,4,2,3,16
36,48,127,135,109,119,574
45,63,182,190,157,159,796
26,90,186,159,113,107,681
35,48,149,153,123,127,635
33,45,121,135,113,126,573
5,8,6,5,5,7,36
4,3,1,5,4,2,19
34,44,134,139,112,119,582
31,47,135,141,109,114,577
12,21,46,31,24,36,170
29,34,82,78,64,94,381
42,65,175,188,158,157,785
27,34,113,109,85,95,463
42,61,158,155,136,148,700
2,6,10,5,5,6,34
27,80,187,167,127,92,680
37,50,142,146,123,121,619
31,41,123,129,94,117,535
7,13,26,27,19,14,106
0,1,1,1,2,1,6
6,12,31,39,32,28,148
8,17,36,40,29,21,151
5,8,13,11,6,8,51
0,35,56,58,44,0,193
0,35,62,65,36,0,198
0,28,59,64,39,0,190
0,37,60,61,43,0,201
0,28,43,48,35,0,154
0,15,22,17,9,0,63
0,19,34,32,18,0,103
0,33,50,47,29,0,159
0,19,34,40,26,0,119
0,27,47,47,28,0,149
0,16,23,24,16,0,79
0,6,9,7,3,0,25
0,10,14,10,6,0,40
0,28,49,54,33,0,164
0,1,2,4,2,0,9
0,27,55,60,31,0,173
0,0,1,2,3,0,6
0,29,45,46,30,0,150
0,30,47,55,31,0,163
0,33,46,48,32,0,159
0,0,1,0,0,0,1
0,22,34,37,21,0,114
0,27,42,48,32,0,149
0,30,47,44,25,0,146
0,1,5,7,4,0,17
0,26,40,47,31,0,144
0,18,27,24,16,0,85
0,33,52,52,31,0,168
0,3,5,6,5,0,19
0,32,47,43,25,0,147
0,24,43,44,24,0,135
0,24,36,37,23,0,120
0,18,28,26,16,0,88
0,25,42,42,24,0,133
0,27,42,46,28,0,143
0,29,46,50,33,0,158
0,27,42,46,28,0,143
0,21,35,37,25,0,118
0,30,49,49,29,0,157
0,28,45,46,29,0,148
0,27,49,49,29,0,154
0,2,5,9,5,0,21
0,30,52,60,37,0,179
0,31,45,51,32,0,159
0,31,48,47,32,0,158
0,21,35,35,26,0,117
0,31,43,50,34,0,158
0,1,1,1,0,0,3
0,30,50,50,35,0,165
0,31,48,47,32,0,158
0,33,48,53,36,0,170
0,9,15,18,13,0,55
0,8,16,15,10,0,49
0,28,47,51,32,0,158
0,31,53,55,33,0,172
0,13,23,18,11,0,65
0,26,45,54,34,0,159
0,8,8,6,6,0,28
0,22,39,37,26,0,124
0,26,47,55,31,0,159
0,33,51,54,31,0,169
0,8,12,10,6,0,36
0,11,15,24,12,0,62
0,15,27,29,15,0,86
0,33,44,54,30,0,161
0,5,6,14,10,0,35
0,2,3,2,1,0,8
0,19,28,36,21,0,104
0,9,18,18,10,0,55
0,28,41,52,27,0,148
0,2,3,3,2,0,10
0,0,0,1,1,0,2
12,18,34,41,32,31,168
45,60,173,172,170,157,777
26,40,94,95,81,96,432
7,17,31,36,22,28,141
46,58,152,154,146,141,697
43,63,165,165,145,157,738
46,64,189,190,160,172,821
42,65,188,185,154,160,794
47,61,162,168,160,152,750
24,39,99,115,104,103,484
15,23,42,42,34,29,185
46,72,204,192,168,165,847
9,14,24,32,25,31,135
36,54,143,147,130,125,635
47,57,167,167,154,165,757
46,72,205,193,168,165,849
51,72,202,196,172,188,881
48,70,190,180,148,171,807
45,60,179,180,148,155,767
10,11,28,29,22,20,120
10,18,39,46,33,25,171
11,17,32,40,35,25,160
44,63,183,184,162,168,804
11,10,21,29,29,27,127
48,65,167,174,156,152,762
38,64,157,177,152,140,728
47,73,206,195,165,171,857
49,71,200,210,174,179,883
17,23,41,45,38,37,201
41,54,159,153,130,154,691
45,69,199,203,170,161,847
29,38,117,128,99,112,523
46,67,193,186,172,177,841
12,18,33,36,34,32,165
15,22,39,42,36,40,194
29,42,113,132,108,110,534
38,58,147,155,132,146,676
44,63,177,184,154,169,791
42,62,150,160,127,133,674
25,32,82,109,84,96,428
18,58,121,119,92,81,489
29,49,104,108,89,98,477
50,62,168,162,143,145,730
17,24,39,39,39,33,191
37,56,156,170,148,163,730
40,57,146,159,145,160,707
13,11,32,36,28,28,148
50,61,167,162,143,143,726
50,68,184,172,154,159,787
45,66,177,178,155,152,773
49,72,197,198,163,176,855
40,67,185,188,161,164,805
40,59,166,174,158,165,762
8,16,35,40,36,30,165
49,68,189,183,159,178,826
47,69,189,186,164,149,804
54,77,194,206,172,190,893
24,38,67,70,63,61,323
11,24,42,43,33,33,186
41,60,169,177,157,181,785
51,62,195,189,167,184,848
11,12,28,37,37,38,163
47,60,178,195,154,156,790
45,56,157,155,133,175,721
51,66,185,186,153,153,794
53,76,211,203,164,172,879
35,49,131,146,124,134,619
2,2,4,3,1,3,15
46,65,179,186,156,161,793
42,66,206,198,160,160,832
51,71,180,173,154,167,796
53,67,186,184,156,160,806
42,66,182,189,156,158,793
47,69,193,204,169,176,858
40,52,144,152,130,146,664
43,59,162,176,156,153,749
32,43,105,100,96,106,482
54,72,184,205,170,169,854
26,39,99,98,84,90,436
49,55,149,144,123,141,661
39,66,154,165,147,144,715
46,69,198,207,167,168,855
45,72,190,188,151,161,807
10,17,32,37,36,30,162
42,57,152,153,135,153,692
52,73,182,186,167,157,817
40,65,178,179,139,143,744
6,18,31,37,36,31,159
15,17,51,57,37,29,206
24,32,89,82,69,72,368
43,66,172,172,152,154,759
16,25,71,74,51,54,291
45,50,152,152,131,133,663
47,62,166,160,140,156,731
47,55,169,173,134,141,719
44,58,143,148,132,150,675
15,32,64,59,43,57,270
48,62,183,179,141,138,751
22,29,84,90,72,78,375
30,50,124,112,90,93,499
41,62,165,162,138,150,718
47,62,180,181,157,170,797
52,72,200,193,172,187,876
23,32,84,90,73,79,381
43,66,178,193,161,158,799
55,79,200,201,168,182,885
45,53,162,178,150,163,751
39,60,156,156,134,158,703
43,66,159,163,139,144,714
41,54,147,152,119,138,651
12,19,39,41,34,37,182
48,70,188,204,166,182,858
34,46,127,136,124,123,590
45,67,180,177,155,177,801
11,17,29,33,29,33,152
20,39,94,116,88,106,463
47,74,196,205,171,182,875
47,68,187,200,171,178,851
47,64,171,181,156,151,770
14,14,30,40,42,41,181
37,60,153,160,139,145,694
49,70,181,185,161,170,816
10,18,32,30,30,31,151
13,16,30,33,28,30,150
41,58,171,183,159,163,775
51,78,206,203,172,166,876
15,22,37,41,37,34,186
40,67,190,197,153,147,794
40,61,175,179,148,130,733
45,63,182,198,175,172,835
49,69,194,191,161,163,827
45,63,182,183,161,178,812
28,55,148,173,127,110,641
1,33,54,62,46,10,206
39,63,194,202,159,164,821
40,62,191,206,162,161,822
29,48,134,145,114,109,579
43,54,169,197,155,154,772
16,31,85,95,79,81,387
1,1,2,1,2,5,12
1,3,7,5,4,12,32
48,75,198,197,164,172,854
47,77,198,201,172,177,872
44,58,194,194,170,172,832
41,68,185,193,169,176,832
21,28,81,86,68,73,357
46,67,190,196,169,164,832
44,68,186,215,180,184,877
44,73,210,205,171,164,867
47,65,192,200,178,174,856
51,77,198,195,165,161,847
53,73,201,191,174,179,871
40,61,180,191,170,164,806
50,66,194,201,172,176,859
50,67,192,187,144,160,800
50,67,192,187,144,160,800
40,61,180,191,170,164,806
50,65,184,199,169,167,834
46,70,175,184,165,168,808
0,0,0,0,1,3,4
58,79,199,202,173,169,880
50,71,178,178,156,176,809
49,63,179,196,160,169,816
42,65,182,197,165,152,803
49,77,190,186,160,168,830
38,61,196,214,180,162,851
50,71,206,192,171,182,872
46,68,197,190,157,156,814
42,69,184,195,178,178,846
44,64,197,213,180,178,876
50,70,184,201,162,172,839
44,64,199,205,162,170,844
48,70,201,202,163,166,850
46,72,199,192,161,166,836
50,65,183,204,174,167,843
45,67,179,195,162,165,813
10,19,37,34,25,30,155
16,45,109,108,80,47,405
25,70,162,147,112,85,601
9,22,47,61,45,40,224
10,22,60,56,34,25,207
28,41,110,115,107,109,510
17,15,56,49,50,60,247
8,18,47,61,42,28,204
21,26,89,95,90,92,413
22,78,174,150,99,89,612
21,30,83,95,79,79,387
33,38,117,119,104,107,518
33,49,141,150,123,122,618
52,61,187,189,170,171,830
23,27,80,97,86,88,401
45,63,169,174,138,147,736
27,33,95,96,79,81,411
48,60,158,170,148,148,732
46,61,185,183,149,165,789
46,59,183,197,169,161,815
42,63,174,185,159,147,770
472,1227,2463,2478,1828,2223,10691
37,52,141,143,127,136,636
41,66,165,172,147,164,755
24,31,76,85,77,85,378
22,25,61,71,64,61,304
53,71,207,203,171,162,867
54,62,172,183,152,161,784
16,23,72,85,62,71,329
28,42,94,98,100,96,458
25,37,88,91,83,87,411
47,61,192,205,175,173,853
13,29,81,62,55,60,300
32,52,126,117,102,118,547
45,72,207,206,176,160,866
43,52,166,174,139,140,714
51,64,187,187,135,153,777
17,30,71,77,75,84,354
381,920,1853,1866,1366,1679,8065
25,34,90,105,95,96,445
45,67,198,193,174,179,856
36,50,145,144,130,130,635
24,37,87,94,83,89,414
24,26,76,66,58,78,328
24,32,96,107,98,82,439
26,30,97,86,64,68,371
35,55,153,151,129,147,670
32,46,114,116,104,106,518
47,58,195,200,176,174,850
18,18,55,64,61,80,296
20,26,68,85,69,71,339
40,60,165,153,124,132,674
30,37,105,108,96,102,478
35,41,122,128,109,113,548
41,56,176,196,154,157,780
49,60,192,206,171,165,843
17,25,79,80,64,62,327
31,40,115,115,111,103,515
24,35,104,103,87,91,444
37,60,152,157,142,149,697
45,60,189,196,155,158,803
20,32,74,70,59,75,330
51,67,193,193,160,146,810
45,67,189,175,153,164,793
49,66,193,202,168,167,845
49,69,191,182,158,164,813
49,67,204,209,166,170,865
24,37,123,128,104,116,532
32,52,140,146,127,139,636
35,49,147,147,123,117,618
34,42,106,121,102,106,511
24,26,77,82,68,67,344
38,55,149,159,123,123,647
30,49,115,110,110,112,526
18,28,61,79,84,73,343
30,50,127,127,112,117,563
48,65,187,194,172,168,834
26,30,66,69,56,55,302
47,63,193,197,156,159,815
19,26,67,63,43,49,267
46,62,191,177,146,153,775
39,54,150,160,124,123,650
24,35,89,90,75,96,409
30,35,110,112,102,107,496
42,47,142,135,118,128,612
44,58,154,155,143,147,701
36,45,144,162,138,137,662
36,46,134,139,128,139,622
30,50,139,143,118,130,610
28,42,109,119,103,90,491
17,28,81,84,71,84,365
33,54,134,139,118,134,612
38,49,144,142,118,144,635
44,58,168,153,138,156,717
46,59,181,170,132,142,730
35,46,131,145,131,155,643
31,42,108,124,107,123,535
46,61,174,173,143,162,759
39,59,166,185,142,150,741
47,73,204,211,179,166,880
30,39,88,84,95,92,428
48,66,186,183,154,158,795
45,63,182,187,166,162,805
41,62,148,142,127,144,664
38,54,146,136,117,121,612
24,31,81,82,67,86,371
17,28,70,77,83,79,354
25,38,95,94,83,103,438
36,49,135,139,126,129,614
35,57,152,169,146,139,698
45,65,197,212,173,176,868
1,2,1,1,4,5,14
25,42,113,122,117,121,540
37,45,128,138,122,144,614
28,56,142,145,121,129,621
33,50,140,131,117,129,600
28,45,111,108,98,104,494
40,58,142,142,128,130,640
29,42,109,107,88,96,471
29,50,104,116,109,119,527
30,43,98,93,86,106,456
5,8,5,9,11,6,44
31,46,125,138,123,123,586
40,61,150,145,136,150,682
50,59,171,184,152,161,777
34,50,119,116,94,119,532
24,39,88,93,87,99,430
32,44,121,117,102,91,507
25,38,92,101,88,91,435
33,49,142,151,124,119,618
16,26,64,72,65,62,305
21,37,87,93,70,91,399
21,24,67,73,59,67,311
19,24,76,76,48,62,305
21,35,107,107,81,78,429
33,36,123,127,93,100,512
50,63,188,184,150,159,794
48,65,193,188,145,155,794
15,27,65,55,45,52,259
49,70,202,209,175,164,869
39,51,144,146,112,127,619
45,71,179,192,171,175,833
47,64,202,203,162,162,840
38,47,125,147,129,113,599
46,53,147,152,140,142,680
50,69,208,202,185,175,889
1003,2721,5439,5466,4086,4847,23562
33,46,124,111,95,107,516
43,67,191,196,182,156,835
46,62,199,201,161,175,844
47,58,179,188,148,161,781
46,66,201,203,163,160,839
53,71,209,203,176,174,886
4,5,3,3,5,15,35
43,51,138,145,134,143,654
42,66,202,215,174,164,863
42,65,172,177,138,152,746
36,42,126,138,117,104,563
29,46,146,150,127,99,597
47,62,167,167,154,156,753
36,56,134,140,131,123,620
44,64,166,175,152,176,777
36,63,191,213,167,174,844
42,56,170,200,170,163,801
32,43,115,118,114,131,553
0,33,54,61,33,0,181
33,45,124,127,112,121,562
38,56,150,153,142,134,673
28,44,129,134,114,86,535
49,68,185,181,157,172,812
44,56,154,155,143,152,704
44,66,203,207,160,167,847
49,63,195,202,174,186,869
33,52,139,152,125,129,630
40,58,190,184,156,133,761
35,49,142,150,112,109,597
51,68,195,209,183,169,875
51,71,196,195,168,162,843
127,216,493,490,406,450,2182
28,39,104,122,113,115,521
42,67,182,192,157,166,806
39,64,163,153,134,133,686
44,62,174,182,155,147,764
35,49,132,141,119,118,594
41,55,121,128,118,132,595
48,64,191,208,184,172,867
47,58,198,211,177,171,862
15,17,52,48,36,47,215
44,67,197,206,165,180,859
46,64,171,181,155,159,776
43,64,208,209,164,170,858
48,69,180,176,156,161,790
34,44,115,121,104,117,535
48,63,185,184,153,163,796
47,64,155,167,148,152,733
51,67,178,187,160,168,811
48,69,200,209,169,168,863
49,71,201,205,155,166,847
0,32,66,62,37,0,197
49,66,176,185,154,158,788
46,62,197,190,170,166,831
41,63,163,164,147,153,731
38,50,135,117,106,115,561
9,34,101,101,76,42,363
48,62,164,171,160,153,758
44,65,192,199,181,151,832
34,45,126,139,121,122,587
33,44,108,102,96,118,501
44,61,153,160,142,155,715
25,38,117,115,100,123,518
27,44,108,113,100,111,503
32,51,143,144,120,127,617
53,63,193,194,160,170,833
32,54,139,147,126,120,618
44,57,153,154,131,139,678
38,63,204,195,153,162,815
36,52,140,143,132,131,634
44,68,207,207,168,167,861
50,67,188,213,167,163,848
32,48,117,137,117,124,575
33,48,139,133,96,96,545
50,61,165,170,152,165,763
0,39,69,87,44,0,239
51,66,185,177,155,165,799
22,67,157,146,114,68,574
30,47,128,144,115,105,569
42,66,199,211,190,182,890
10,20,56,66,41,39,232
12,52,120,122,78,38,422
12,25,60,74,50,47,268
43,65,160,161,147,142,718
5,34,72,85,57,13,266
0,40,72,87,45,0,244
12,21,55,66,45,39,238
33,47,114,134,112,118,558
41,57,131,134,118,121,602
35,50,147,173,138,139,682
51,70,167,172,155,175,790
36,57,143,142,136,143,657
19,65,140,127,87,55,493
13,26,63,61,52,48,263
39,73,204,201,171,157,845
24,47,126,135,104,71,507
0,32,60,71,47,0,210
15,26,65,66,47,42,261
12,23,59,72,52,45,263
13,27,59,70,52,50,271
47,65,161,181,154,147,755
53,62,174,168,148,156,761
42,60,160,174,144,144,724
37,42,107,125,121,109,541
31,104,240,224,143,107,849
23,61,158,139,108,83,572
18,38,95,97,70,39,357
10,29,67,57,47,44,254
27,58,150,134,104,112,585
16,24,70,67,52,46,275
12,22,63,66,51,52,266
49,71,183,176,154,172,805
46,74,166,172,149,160,767
0,39,69,82,44,0,234
32,110,251,222,155,131,901
16,25,64,66,51,45,267
33,45,125,135,117,124,579
49,66,162,175,143,140,735
41,53,157,164,138,150,703
42,62,185,189,152,157,787
37,53,128,141,124,131,614
39,61,159,171,137,142,709
0,35,64,81,55,0,235
43,63,160,163,147,162,738
43,62,192,198,162,163,820
33,47,151,145,110,129,615
49,64,175,177,152,157,774
16,22,63,58,47,41,247
13,27,64,62,46,51,263
0,34,60,80,49,0,223
12,25,68,68,53,50,276
36,56,148,153,135,146,674
18,42,88,82,66,52,348
29,87,214,195,145,115,785
2,39,74,76,55,14,260
34,54,152,155,143,155,693
18,38,84,81,72,89,382
14,25,60,69,57,38,263
14,23,58,71,45,42,253
38,57,141,153,135,137,661
54,66,175,180,153,159,787
35,53,133,130,108,127,586
35,49,133,140,116,122,595
45,69,163,173,143,154,747
51,66,170,175,153,154,769
35,40,111,131,118,101,536
35,103,238,214,150,124,864
39,57,153,148,140,151,688
54,72,192,190,165,166,839
42,60,160,174,144,144,724
11,22,49,47,56,59,244
27,100,235,213,141,113,829
39,82,213,197,155,137,823
25,83,197,181,129,92,707
53,62,178,177,157,166,793
32,44,130,141,116,135,598
24,83,208,208,144,98,765
15,26,63,61,52,48,265
49,71,172,176,155,159,782
45,68,177,178,153,152,773
21,32,81,81,77,64,356
46,65,169,168,149,172,769
46,66,174,176,143,155,760
5,39,71,79,47,19,260
34,50,116,130,117,132,579
52,64,164,176,155,162,773
15,25,57,64,46,35,242
43,51,141,153,147,146,681
0,41,80,89,43,0,253
53,67,179,177,165,165,806
0,37,71,72,41,0,221
14,27,61,79,52,39,272
10,23,48,62,46,43,232
43,47,144,142,138,144,658
31,45,112,124,104,106,522
0,39,71,79,48,0,237
0,43,76,85,39,0,243
14,22,59,65,47,47,254
9,20,60,72,52,42,255
0,39,62,80,54,0,235
50,73,203,211,175,176,888
34,42,111,115,103,106,511
0,39,76,75,41,0,231
47,73,193,183,159,169,824
16,21,49,52,42,53,233
18,37,99,121,107,106,488
0,32,63,78,51,0,224
54,65,173,173,152,159,776
26,32,96,101,64,70,389
53,62,171,181,156,161,784
54,71,180,173,158,172,808
2,41,70,80,43,6,242
0,41,71,73,54,0,239
52,63,168,187,159,161,790
39,58,145,147,137,138,664
34,39,114,117,91,113,508
20,41,128,134,99,92,514
1,44,74,75,47,21,262
39,55,136,141,124,126,621
51,62,161,162,140,154,730
32,42,111,116,103,105,509
0,38,64,72,32,0,206
33,45,135,137,101,115,566
51,70,202,193,171,188,875
12,24,55,59,43,45,238
13,26,61,65,50,33,248
21,38,88,94,70,74,385
19,31,75,80,67,69,341
51,67,186,183,153,184,824
48,68,193,191,160,190,850
15,16,40,51,37,33,192
41,62,160,174,153,156,746
46,75,187,206,176,157,847
13,26,63,70,57,36,265
18,25,57,69,48,51,268
14,19,38,49,40,37,197
44,60,169,180,161,167,781
46,75,195,198,169,185,868
16,25,48,46,37,43,215
42,68,177,176,158,149,770
37,57,133,137,132,129,625
10,17,41,50,33,31,182
11,17,36,51,41,32,188
17,25,53,58,47,47,247
13,18,59,61,53,60,264
18,23,48,53,37,44,223
9,19,52,67,48,43,238
52,73,198,201,181,184,889
53,69,200,192,173,190,877
14,24,60,68,47,38,251
48,67,171,180,155,172,793
43,64,157,153,134,136,687
48,71,198,196,171,181,865
47,71,189,195,168,167,837
17,22,45,57,39,50,230
11,18,41,45,34,37,186
17,25,51,57,45,47,242
14,23,59,52,44,50,242
48,67,171,180,155,172,793
11,22,52,60,43,48,236
11,22,52,60,43,48,236
34,39,116,128,111,107,535
50,62,181,168,147,176,784
51,70,208,212,167,177,885
12,19,38,39,32,29,169
18,27,61,80,51,47,284
18,26,49,54,45,40,232
51,73,179,186,150,159,798
19,24,59,63,40,45,250
43,71,200,199,160,184,857
31,44,135,133,110,111,564
35,49,130,141,121,130,606
15,22,47,54,45,31,214
50,71,188,203,173,178,863
47,71,193,200,162,170,843
46,69,207,211,182,203,918
57,73,210,198,169,183,890
51,69,187,180,154,165,806
57,79,208,207,180,169,900
17,28,66,66,47,49,273
54,74,207,196,176,186,893
41,58,196,210,170,171,846
49,63,183,185,170,174,824
36,45,108,126,103,116,534
42,69,195,204,171,171,852
13,20,45,52,50,40,220
28,46,111,104,96,111,496
51,68,187,186,163,178,833
45,68,179,197,161,180,830
16,25,58,53,43,46,241
47,76,208,209,182,176,898
15,28,51,57,51,43,245
14,21,43,47,41,46,212
44,70,170,168,154,164,770
42,62,205,193,163,175,840
46,70,189,190,160,170,825
15,31,76,86,77,89,374
18,25,57,72,47,49,268
42,69,187,194,166,166,824
48,65,168,173,155,147,756
51,71,185,184,172,155,818
50,70,201,205,180,182,888
15,25,42,52,39,30,203
15,19,43,49,33,37,196
18,25,46,60,45,40,234
14,20,41,58,44,48,225
16,23,44,56,46,33,218
45,75,181,196,172,167,836
15,25,64,68,53,60,285
31,46,111,117,101,102,508
46,68,191,198,169,168,840
11,17,40,48,42,44,202
47,73,189,195,167,166,837
16,24,59,70,47,37,253
14,17,36,50,38,37,192
47,68,182,189,155,162,803
50,68,195,210,181,191,895
15,28,59,75,48,40,265
25,46,109,103,95,88,466
28,39,93,101,89,84,434
17,23,43,45,33,34,195
16,23,51,55,43,31,219
31,56,142,129,112,118,588
53,72,185,184,163,169,826
37,52,136,139,126,131,621
16,27,63,72,68,66,312
14,22,45,48,36,39,204
15,24,61,73,55,46,274
16,21,61,64,41,44,247
50,68,175,186,163,168,810
41,57,131,131,116,121,597
49,71,192,189,164,153,818
46,71,194,184,151,162,808
44,62,164,172,150,171,763
49,59,155,174,153,153,743
44,67,190,208,171,167,847
47,69,202,199,161,173,851
46,65,176,184,163,187,821
50,68,188,188,174,196,864
15,21,42,52,42,37,209
15,13,32,43,33,27,163
43,59,174,183,152,154,765
45,65,180,196,156,170,812
54,83,211,206,176,190,920
50,66,188,193,170,175,842
51,70,178,183,155,153,790
53,74,182,176,156,176,817
45,57,187,191,167,163,810
44,67,181,189,165,165,811
24,29,69,57,52,51,282
29,49,133,156,139,132,638
49,77,203,201,178,175,883
14,20,47,55,45,41,222
10,14,36,44,37,26,167
11,20,42,47,34,38,192
46,69,180,188,162,170,815
48,57,187,194,163,183,832
48,63,175,173,157,168,784
45,67,174,182,165,166,799
43,73,189,213,170,177,865
52,68,209,201,176,178,884
44,61,156,165,140,150,716
45,64,175,177,152,171,784
10,17,36,41,28,25,157
13,18,36,41,36,34,178
51,70,192,180,154,185,832
48,72,191,195,150,179,835
13,16,44,43,41,44,201
48,69,183,190,168,164,822
46,66,183,202,168,163,828
49,66,191,191,164,165,826
46,67,189,193,166,175,836
12,26,44,46,37,36,201
45,62,177,169,150,154,757
13,27,49,54,46,45,234
44,66,186,196,152,168,812
55,67,209,207,153,174,865
12,19,39,52,44,39,205
47,70,188,186,168,170,829
44,70,184,190,167,163,818
50,65,185,203,171,190,864
53,75,210,209,185,186,918
46,67,186,199,157,170,825
10,18,46,48,44,42,208
45,58,180,196,158,171,808
54,70,199,199,168,172,862
42,65,188,192,160,164,811
42,70,185,189,157,176,819
54,70,200,202,172,159,857
53,76,205,207,178,171,890
52,68,209,202,179,179,889
43,68,179,199,168,186,843
47,68,176,191,158,160,800
13,23,45,54,40,32,207
49,68,193,212,174,171,867
52,69,199,207,185,189,901
52,69,192,185,159,189,846
42,66,184,201,174,179,846
13,21,38,38,36,32,178
50,74,222,207,176,164,893
12,18,42,49,42,44,207
13,17,38,42,39,38,187
45,70,182,191,178,194,860
33,45,140,142,119,122,601
46,58,189,190,159,166,808
42,58,141,149,131,137,658
18,27,67,68,53,57,290
13,36,86,64,59,78,336
15,47,95,108,67,54,386
32,49,140,133,103,110,567
35,56,147,148,120,138,644
45,69,191,202,164,166,837
32,58,142,151,118,123,624
35,51,137,139,119,126,607
35,60,153,154,133,155,690
34,49,124,131,121,133,592
9,16,26,34,24,27,136
13,46,104,100,66,49,378
20,46,112,94,60,45,377
27,31,106,100,90,76,430
24,84,164,163,114,81,630
2,1,1,3,2,2,11
21,68,163,162,132,129,675
37,53,158,155,122,129,654
23,40,118,123,94,88,486
28,39,120,126,106,114,533
39,58,166,172,133,148,716
0,28,45,48,33,0,154
46,61,175,190,171,177,820
46,62,168,160,153,149,738
27,44,145,152,120,131,619
31,41,113,131,117,116,549
32,46,143,153,134,130,638
18,30,100,104,89,90,431
41,51,146,136,120,137,631
43,59,160,174,143,139,718
34,45,127,139,118,113,576
3,5,5,8,5,9,35
39,52,151,180,140,138,700
22,25,70,72,63,58,310
19,29,84,92,83,90,397
29,30,87,97,86,77,406
27,38,95,87,80,84,411
1,5,4,4,2,5,21
40,57,146,137,124,131,635
46,56,175,184,141,142,744
31,46,108,114,93,104,496
37,45,130,141,117,117,587
29,41,109,118,95,100,492
27,38,105,107,89,90,456
20,31,80,87,67,70,355
32,46,107,97,90,105,477
42,54,152,148,134,125,655
33,45,128,114,97,105,522
32,42,110,112,99,102,497
30,45,119,138,122,123,577
30,42,108,113,95,98,486
34,50,130,153,126,121,614
30,45,127,136,100,102,540
43,66,156,156,149,161,731
44,59,163,167,150,150,733
33,43,121,132,110,114,553
41,51,157,173,143,142,707
40,49,158,171,137,144,699
4,3,3,4,2,2,18
16,24,61,73,62,57,293
40,49,151,166,136,117,659
16,17,45,55,55,37,225
42,48,151,163,140,138,682
35,45,137,143,123,130,613
48,61,153,160,144,145,711
44,60,163,178,138,137,720
37,61,171,179,150,143,741
22,39,106,119,99,93,478
43,68,179,186,156,165,797
31,44,116,113,103,82,489
46,65,190,212,169,173,855
35,36,121,120,104,103,519
18,31,61,87,93,86,376
29,31,78,88,86,95,407
42,56,161,160,144,129,692
29,49,127,131,108,118,562
37,59,152,141,134,126,649
34,51,123,143,122,117,590
33,47,140,144,109,113,586
2,4,4,5,4,0,19
26,32,78,95,81,75,387
38,59,153,161,137,132,680
39,59,169,170,146,145,728
32,44,115,118,95,105,509
36,55,166,183,149,154,743
27,35,109,108,88,99,466
44,60,178,205,164,170,821
5,6,4,3,3,0,21
45,63,172,172,147,151,750
34,55,152,157,134,137,669
35,49,137,133,107,107,568
40,51,145,155,141,142,674
36,53,139,147,121,135,631
45,67,189,183,160,163,807
37,48,147,142,121,136,631
41,57,175,179,150,145,747
29,42,103,107,83,91,455
27,41,99,110,95,93,465
51,69,178,187,147,142,774
36,58,132,147,121,122,616
22,39,107,108,90,97,463
45,56,163,180,149,144,737
42,63,179,188,157,156,785
23,31,94,101,88,95,432
18,21,63,64,53,54,273
42,57,178,173,145,131,726
42,51,166,162,137,150,708
16,17,59,56,47,50,245
45,54,161,156,132,115,663
26,37,96,91,74,75,399
16,27,75,91,79,83,371
27,31,82,96,88,80,404
50,68,198,213,166,174,869
48,66,200,200,160,150,824
47,65,194,211,167,169,853
0,31,65,60,32,0,188
35,44,122,123,106,102,532
31,55,138,141,106,130,601
17,22,66,75,76,69,325
44,66,199,201,158,171,839
50,69,197,189,160,181,846
24,26,85,90,70,75,370
49,72,213,211,163,156,864
49,59,179,190,155,159,791
30,42,109,102,93,97,473
47,62,199,206,172,181,867
53,70,193,195,156,158,825
50,69,173,176,162,159,789
0,32,57,65,40,0,194
47,61,183,190,157,163,801
45,66,179,194,173,182,839
40,55,149,157,140,123,664
46,60,158,170,160,163,757
43,63,180,184,164,164,798
0,34,73,74,48,0,229
34,50,130,129,107,103,553
55,65,167,173,150,149,759
0,34,59,80,46,0,219
48,66,161,172,162,170,779
44,73,209,195,159,157,837
52,71,168,173,154,154,772
47,69,200,199,161,169,845
41,58,147,141,114,138,639
45,63,156,164,147,153,728
51,73,214,201,165,166,870
52,73,175,190,169,167,826
46,58,141,152,140,148,685
0,39,72,79,47,0,237
44,63,172,189,163,166,797
48,74,193,192,167,178,852
0,35,56,67,38,0,196
54,59,189,200,173,160,835
54,64,171,172,152,169,782
43,64,163,162,128,144,704
45,70,196,218,165,169,863
48,67,194,189,164,169,831
0,43,87,77,54,0,261
52,61,155,158,143,151,720
0,29,65,62,41,0,197
43,63,161,157,138,161,723
0,28,68,69,37,0,202
37,58,154,157,121,130,657
48,63,195,208,177,169,860
51,63,185,182,148,157,786
51,80,205,206,155,165,862
49,55,152,162,131,138,687
51,67,211,203,168,171,871
50,72,197,204,159,171,853
47,67,163,153,124,136,690
0,36,77,69,57,0,239
52,59,169,178,149,153,760
0,34,67,72,48,0,221
46,59,155,156,138,148,702
0,31,67,67,45,0,210
0,43,81,82,54,0,260
48,66,178,183,160,165,800
46,68,203,205,173,166,861
51,68,172,168,138,156,753
51,63,153,162,148,155,732
51,67,192,206,164,168,848
34,49,142,142,107,123,597
52,59,169,178,149,154,761
42,58,151,162,130,135,678
0,1,0,0,0,0,1
54,69,205,213,170,178,889
28,39,100,91,71,100,429
39,46,118,127,119,115,564
41,55,154,163,134,136,683
48,57,178,193,146,149,771
46,65,203,216,174,171,875
61,133,280,294,237,248,1253
33,45,143,142,122,136,621
33,56,137,141,125,128,620
37,54,139,143,122,118,613
18,20,70,71,60,70,309
42,64,174,204,157,156,797
23,30,64,63,71,82,333
18,32,82,84,64,68,348
29,38,111,113,95,101,487
45,59,160,156,127,129,676
40,51,141,136,119,136,623
34,49,147,139,119,113,601
48,64,171,187,160,174,804
46,66,184,194,155,158,803
35,53,165,143,121,135,652
34,44,121,140,114,113,566
45,63,158,158,124,122,670
39,53,147,142,112,118,611
35,48,126,149,124,140,622
31,45,120,110,93,113,512
38,49,132,142,139,124,624
35,45,120,125,101,118,544
34,50,136,140,114,116,590
38,50,150,145,116,114,613
42,56,151,162,137,141,689
39,50,135,123,111,121,579
15,21,59,55,41,47,238
37,52,145,148,135,126,643
32,44,129,129,106,105,545
29,37,106,110,93,96,471
48,63,185,192,150,146,784
26,33,90,105,89,94,437
41,60,159,159,146,144,709
44,63,173,174,137,144,735
39,48,143,144,119,132,625
26,45,120,125,92,110,518
26,35,99,83,68,94,405
21,35,101,112,93,95,457
27,40,95,86,76,78,402
25,28,77,80,63,84,357
21,30,89,86,65,70,361
14,25,74,85,76,71,345
14,25,74,85,76,71,345
18,28,72,81,84,95,378
19,28,57,73,58,48,283
20,27,75,71,74,80,347
1,2,0,6,5,0,14
17,16,45,62,56,55,251
20,29,54,68,69,67,307
38,49,146,155,135,128,651
2,3,3,3,2,2,15
26,40,113,115,93,103,490
26,33,95,83,72,84,393
23,26,85,100,86,95,415
19,28,85,97,83,83,395
22,32,74,73,63,47,311
34,51,151,154,139,144,673
26,38,98,112,102,96,472
34,48,140,142,117,118,599
32,42,113,104,90,112,493
18,22,57,58,55,51,261
30,43,116,120,102,98,509
19,20,64,65,61,63,292
1,1,0,1,1,5,9
16,19,57,66,58,56,272
15,23,74,68,57,69,306
45,63,181,180,149,155,773
44,64,181,194,174,157,814
43,64,168,167,146,132,720
24,34,62,69,64,63,316
14,20,61,63,57,57,272
14,20,61,63,57,57,272
48,69,166,200,174,174,831
44,63,181,195,172,174,829
49,63,190,195,187,166,850
51,66,180,198,168,166,829
46,58,177,185,159,175,800
38,58,168,179,150,160,753
48,62,179,185,175,181,830
43,63,182,198,162,167,815
43,68,182,189,166,169,817
34,43,113,129,100,120,539
48,65,185,197,160,152,807
31,44,128,133,112,114,562
34,55,139,141,114,133,616
39,48,161,172,133,135,688
19,23,74,92,70,69,347
36,51,136,147,129,120,619
46,59,174,188,145,159,771
34,38,102,114,100,105,493
32,48,129,124,94,110,537
34,48,120,111,110,113,536
34,48,120,111,110,113,536
38,44,156,162,136,129,665
37,48,146,157,128,124,640
30,27,108,102,88,87,442
25,30,70,77,83,64,349
36,51,150,151,128,136,652
38,60,165,174,128,139,704
41,51,153,158,127,128,658
42,54,161,165,129,143,694
49,61,202,200,173,164,849
45,70,179,198,179,171,842
22,39,90,105,89,78,423
18,40,94,97,86,88,423
47,65,184,188,151,147,782
47,67,192,181,156,172,815
25,32,83,94,90,90,414
29,40,112,124,106,115,526
32,40,115,117,102,104,510
28,43,83,97,101,91,443
48,65,187,202,180,172,854
37,53,148,156,137,137,668
43,59,166,152,130,147,697
43,62,164,163,141,141,714
30,38,104,106,90,95,463
34,42,131,118,100,102,527
37,57,156,181,157,164,752
38,60,145,147,131,132,653
23,31,85,105,90,80,414
32,49,132,153,125,119,610
24,33,77,99,94,96,423
38,44,133,154,117,120,606
32,55,145,155,125,125,637
42,51,163,165,130,140,691
44,64,179,194,152,166,799
34,45,139,165,139,143,665
42,64,179,188,163,160,796
43,64,179,189,161,163,799
48,64,184,192,156,171,815
45,62,193,196,168,178,842
38,49,143,131,121,124,606
46,63,206,208,171,163,857
47,68,189,203,177,169,853
37,60,168,184,146,146,741
45,63,182,182,140,158,770
43,54,182,180,152,144,755
54,63,204,200,175,173,869
44,60,175,176,146,161,762
41,58,150,145,126,145,665
44,61,188,198,166,166,823
44,64,174,181,150,154,767
35,53,147,154,131,131,651
53,66,189,209,165,167,849
43,61,185,192,157,161,799
46,66,167,164,138,146,727
37,59,165,173,145,137,716
33,48,125,135,116,104,561
35,47,134,136,115,117,584
33,42,135,133,111,102,556
41,64,187,199,158,162,811
47,59,193,198,153,150,800
47,70,195,195,157,166,830
35,52,138,151,132,124,632
31,45,123,117,106,120,542
51,69,191,192,167,158,828
52,64,188,178,165,181,828
45,69,205,204,166,162,851
45,66,170,181,157,157,776
45,66,170,181,157,157,776
45,62,173,199,165,150,794
45,64,176,184,155,158,782
49,64,199,207,163,162,844
52,65,179,184,151,166,797
43,67,176,179,143,158,766
47,59,189,185,165,181,826
44,63,203,202,161,178,851
36,47,121,122,100,102,528
49,68,201,201,165,173,857
27,39,116,109,96,96,483
47,64,207,211,186,188,903
44,63,186,187,147,165,792
45,64,183,188,157,162,799
45,75,208,205,166,164,863
37,50,138,148,127,142,642
52,73,202,184,162,168,841
46,71,195,202,166,164,844
53,68,205,206,158,167,857
46,71,204,201,176,186,884
49,75,209,191,165,181,870
15,32,70,67,58,66,308
49,59,179,179,172,170,808
50,65,194,186,169,172,836
53,71,208,191,163,182,868
45,68,185,196,179,172,845
45,68,210,208,172,165,868
51,65,205,207,162,175,865
42,65,168,169,146,154,744
42,59,155,171,150,162,739
48,60,169,175,147,156,755
50,67,192,191,168,158,826
41,57,172,188,142,155,755
45,64,185,185,173,177,829
42,60,163,161,142,141,709
47,57,192,203,161,156,816
48,70,210,202,170,169,869
35,46,149,142,115,136,623
46,71,180,190,159,167,813
54,63,171,182,154,173,797
40,63,181,174,158,167,783
43,61,166,175,152,175,772
34,49,140,151,130,127,631
31,48,139,130,105,106,559
20,25,61,66,51,55,278
46,64,221,208,172,157,868
409,1033,2114,2107,1538,1896,9097
37,55,128,129,112,120,581
33,44,124,125,120,125,571
53,66,199,203,149,165,835
33,49,148,166,144,159,699
37,52,133,153,131,124,630
40,52,150,155,134,134,665
45,62,171,163,158,154,753
40,54,143,147,127,129,640
38,49,144,149,128,144,652
35,52,152,161,138,131,669
40,59,147,163,139,145,693
40,59,155,158,136,143,691
49,66,176,185,155,159,790
20,30,77,68,55,59,309
27,49,116,112,107,107,518
25,37,101,103,95,106,467
31,52,117,116,94,105,515
25,40,113,133,114,137,562
26,39,105,128,110,112,520
27,51,121,121,115,127,562
29,39,94,98,88,86,434
48,64,205,197,162,176,852
51,66,202,196,159,137,811
40,70,200,189,162,161,822
35,53,169,175,147,119,698
39,64,178,182,165,176,804
48,63,160,168,161,161,761
32,43,109,127,112,116,539
20,42,111,107,85,84,449
46,69,192,186,146,169,808
47,66,201,204,176,166,860
43,61,207,195,166,157,829
19,29,80,82,71,70,351
43,65,195,219,179,180,881
42,62,202,222,169,159,856
47,60,177,200,158,162,804
40,58,188,196,163,151,796
55,70,198,202,167,179,871
51,69,202,202,178,179,881
47,65,193,186,159,165,815
47,71,183,188,147,147,783
47,63,176,202,168,160,816
493,1309,2656,2692,1983,2338,11471
366,793,1654,1650,1193,1456,7112
46,61,182,193,176,156,814
0,38,69,57,31,0,195
34,50,143,152,145,123,647
0,34,59,61,32,0,186
0,37,59,64,31,0,191
0,38,62,64,35,0,199
0,37,60,65,36,0,198
48,71,178,182,155,155,789
32,60,162,163,141,128,686
50,63,200,194,160,168,835
42,64,195,201,164,159,825
37,52,148,155,132,141,665
41,71,185,193,167,161,818
0,32,64,63,32,0,191
54,72,169,175,145,166,781
49,70,166,167,142,160,754
38,58,149,159,139,143,686
45,64,168,178,151,153,759
50,70,201,202,169,179,871
47,66,204,203,168,169,857
53,63,164,164,149,151,744
47,54,156,167,151,156,731
50,67,164,163,139,147,730
49,57,162,167,145,160,740
43,55,144,156,131,134,663
38,55,136,142,128,129,628
48,59,148,153,141,138,687
47,58,157,160,141,148,711
46,69,202,188,151,182,838
46,63,168,173,142,146,738
49,63,167,181,149,161,770
48,65,197,193,157,180,840
51,62,195,183,155,171,817
46,67,198,188,153,148,800
39,67,198,191,171,185,851
42,66,197,195,177,178,855
55,65,203,209,168,166,866
51,63,203,207,165,175,864
53,70,196,205,166,178,868
49,74,196,205,164,164,852
41,68,203,201,170,166,849
47,69,196,202,172,175,861
0,35,62,61,35,0,193
0,36,63,61,35,0,195
0,35,73,72,48,0,228
46,67,186,201,171,167,838
49,69,216,221,168,181,904
48,73,211,192,161,177,862
42,68,190,200,164,150,814
51,65,210,206,163,167,862
49,63,194,187,166,173,832
49,67,188,186,153,173,816
39,51,139,152,130,136,647
50,59,164,184,152,163,772
44,59,155,167,153,167,745
54,74,179,179,159,156,801
54,74,180,180,159,156,803
54,70,175,181,163,150,793
46,61,202,198,158,163,828
46,68,192,202,156,166,830
50,64,169,176,166,158,783
45,66,178,170,151,156,766
52,68,178,173,151,176,798
45,61,150,164,128,127,675
52,74,197,207,171,175,876
51,73,171,176,161,170,802
51,71,168,167,155,157,769
51,67,179,178,154,169,798
18,30,88,94,84,79,393
37,54,141,146,133,142,653
51,63,165,178,157,164,778
36,52,138,139,108,120,593
36,50,128,133,115,127,589
36,53,151,162,131,144,677
50,71,193,202,168,187,871
47,68,192,197,173,191,868
41,61,164,169,149,151,735
48,59,158,170,147,159,741
52,62,185,173,154,176,802
49,66,189,198,172,174,848
44,69,203,192,157,175,840
36,52,118,129,107,126,568
35,47,134,146,126,118,606
45,69,198,207,166,145,830
40,52,141,141,116,128,618
38,51,138,142,119,131,619
32,52,126,130,106,119,565
0,30,67,61,37,0,195
0,32,61,70,40,0,203
49,65,206,198,162,173,853
50,70,211,203,167,170,871
49,67,195,198,161,177,847
45,74,207,200,171,185,882
45,74,207,200,171,185,882
41,69,220,209,171,182,892
53,64,196,203,164,151,831
48,65,195,187,164,167,826
55,80,210,222,168,160,895
21,38,96,97,92,85,429
54,70,201,204,169,166,864
33,52,160,159,134,133,671
46,62,206,205,171,179,869
23,40,100,111,83,98,455
0,29,63,61,45,0,198
0,33,63,67,41,0,204
47,64,178,193,160,169,811
0,32,66,68,38,0,204
0,36,72,76,54,0,238
32,44,146,160,138,118,638
14,34,80,92,65,41,326
17,34,87,101,76,60,375
35,53,156,170,142,143,699
0,32,79,63,50,0,224
0,36,68,78,52,0,234
46,67,197,194,172,167,843
50,65,194,198,165,155,827
18,29,77,83,60,65,332
44,63,159,163,143,156,728
47,70,169,172,159,168,785
0,28,68,80,49,0,225
0,35,68,74,56,0,233
0,37,66,66,48,0,217
0,40,75,75,53,0,243
0,36,80,79,51,0,246
0,39,88,81,45,0,253
51,75,195,202,169,169,861
0,31,72,66,46,0,215
49,64,203,210,174,181,881
47,65,207,201,168,162,850
41,63,177,176,147,153,757
36,57,186,200,154,154,787
0,37,65,72,49,0,223
44,64,202,198,163,171,842
40,50,127,128,113,113,571
51,69,182,181,158,158,799
52,77,190,190,168,166,843
15,26,58,61,51,53,264
47,68,196,211,167,170,859
51,64,174,172,150,147,758
56,67,168,170,143,155,759
52,67,177,177,157,154,784
24,34,128,128,100,90,504
20,39,104,102,82,75,422
40,60,148,161,134,131,674
50,68,179,174,149,171,791
28,46,115,116,107,93,505
14,21,59,70,46,44,254
24,29,96,100,74,68,391
16,30,79,82,76,62,345
12,20,47,55,44,38,216
0,37,66,77,47,0,227
14,23,49,60,48,40,234
29,53,146,147,128,134,637
23,30,77,84,69,73,356
39,61,139,133,119,138,629
44,61,163,168,145,154,735
1,40,68,82,42,8,241
44,94,218,209,167,161,893
25,43,117,127,104,69,485
4,38,66,74,44,1,227
54,63,178,179,155,156,785
56,74,193,190,165,177,855
0,38,62,84,49,0,233
14,26,57,66,49,47,259
32,39,113,117,94,91,486
41,53,139,150,134,148,665
18,33,97,92,71,66,377
0,34,66,66,30,5,201
57,66,206,202,169,193,893
44,65,198,208,160,158,833
52,71,204,198,167,183,875
12,26,58,53,42,51,242
13,21,49,44,33,52,212
10,18,36,42,30,35,171
13,20,37,50,37,46,203
48,66,204,205,164,171,858
46,63,177,174,147,160,767
13,23,53,58,59,68,274
15,24,63,71,51,42,266
43,69,173,186,156,177,804
35,43,113,129,109,114,543
52,71,211,197,175,191,897
50,71,214,208,171,189,903
13,28,57,72,56,40,266
4,5,3,6,5,8,31
31,43,104,119,102,91,490
22,46,93,93,93,102,449
56,78,201,212,191,191,929
44,64,192,189,160,175,824
48,61,176,188,151,167,791
51,66,195,216,173,163,864
45,61,186,191,164,172,819
12,23,57,59,37,42,230
45,67,185,204,176,168,845
47,74,195,189,177,167,849
62,70,209,198,170,194,903
51,73,198,209,178,171,880
51,71,189,194,163,176,844
50,66,190,196,156,171,829
47,68,201,201,164,183,864
12,21,49,56,45,43,226
45,75,200,201,175,189,885
42,61,161,166,140,147,717
42,59,164,169,141,163,738
54,70,191,190,169,170,844
43,61,171,179,158,144,756
14,22,44,45,40,35,200
50,68,202,208,159,175,862
10,19,39,50,39,33,190
52,66,195,209,175,174,871
44,66,193,209,168,165,845
45,67,207,213,179,175,886
50,71,206,197,170,181,875
12,13,33,36,36,30,160
56,83,199,206,177,177,898
9,17,35,44,41,35,181
11,21,40,47,39,39,197
10,23,41,38,37,35,184
10,16,43,48,35,35,187
11,19,49,59,42,34,214
28,51,111,127,105,132,554
45,63,181,189,165,173,816
31,53,131,145,132,115,607
48,70,176,186,154,154,788
44,69,182,176,163,166,800
46,73,197,193,161,163,833
50,68,193,211,170,169,861
48,69,195,191,157,180,840
48,72,191,195,150,179,835
30,45,104,96,82,96,453
7,13,32,43,31,24,150
46,67,176,179,153,157,778
51,71,193,179,155,172,821
48,69,184,207,166,174,848
48,64,185,181,163,183,824
40,59,170,181,150,150,750
53,69,187,182,162,162,815
8,13,28,38,33,43,163
12,18,35,43,34,28,170
51,70,201,197,172,177,868
12,17,34,32,32,39,166
44,58,148,150,128,140,668
12,22,43,44,33,37,191
11,21,40,44,32,35,183
45,69,174,184,157,186,815
28,41,104,99,79,99,450
46,76,196,208,168,180,874
47,66,172,182,164,161,792
46,61,167,166,139,145,724
43,57,166,184,167,157,774
47,61,168,167,159,163,765
47,58,176,181,156,161,779
33,43,99,116,109,111,511
38,49,129,129,107,101,553
49,64,172,162,150,150,747
40,67,171,178,146,142,744
9,31,47,45,38,34,204
19,21,77,88,80,83,368
17,28,86,80,71,81,363
13,46,89,91,77,51,367
19,55,107,92,68,66,407
43,65,182,166,146,168,770
43,61,168,181,152,146,751
46,52,139,159,138,152,686
8,19,28,39,34,23,151
20,49,105,87,61,56,378
8,20,59,66,42,36,231
22,65,146,131,96,80,540
17,31,82,96,78,81,385
8,7,15,14,12,18,74
26,34,109,108,91,112,480
40,56,156,151,127,132,662
3,5,4,8,6,6,32
47,54,161,176,131,134,703
2,3,0,3,5,7,20
36,45,142,134,100,113,570
0,1,1,3,2,0,7
0,23,37,36,24,0,120
0,34,50,49,33,0,166
30,44,128,133,112,114,561
39,57,156,172,151,149,724
28,33,115,109,99,109,493
29,50,117,120,94,103,513
48,65,187,175,152,155,782
22,34,79,74,58,70,337
23,36,95,101,78,89,422
32,54,156,175,131,131,679
47,70,199,203,177,168,864
14,20,43,43,37,34,191
17,27,71,69,61,61,306
25,32,90,92,87,79,405
41,62,176,177,152,149,757
45,62,168,177,149,155,756
37,47,121,133,109,109,556
32,48,124,139,133,131,607
47,60,169,187,156,154,773
46,71,194,204,176,168,859
36,50,153,155,127,141,662
43,52,146,153,142,151,687
37,49,128,124,110,112,560
33,46,116,115,92,95,497
47,58,169,178,142,150,744
52,59,180,180,155,155,781
50,72,188,201,175,169,855
40,56,147,142,130,146,661
34,52,150,182,147,150,715
47,62,183,186,157,160,795
51,75,203,198,156,154,837
54,72,188,192,159,165,830
51,63,177,182,158,162,793
40,54,144,155,133,135,661
33,49,126,132,115,131,586
41,57,153,155,132,145,683
37,58,148,157,135,156,691
32,37,101,109,97,121,497
44,62,153,147,130,141,677
0,32,64,68,44,0,208
0,32,60,68,43,0,203
0,34,68,64,46,0,212
46,68,191,193,165,172,835
0,34,56,66,44,0,200
0,41,71,68,47,0,227
53,58,195,199,172,163,840
49,70,188,189,167,171,834
8,33,87,95,61,51,335
15,35,86,90,68,39,333
50,73,184,178,148,169,802
32,43,109,128,113,119,544
46,62,198,207,173,187,873
33,49,125,131,119,127,584
13,28,59,68,55,50,273
12,55,115,116,83,45,426
12,26,60,77,49,39,263
13,25,61,68,46,43,256
0,38,65,73,46,0,222
15,21,64,67,48,45,260
14,25,50,53,46,40,228
39,60,147,150,145,145,686
15,43,83,82,58,47,328
13,27,50,50,44,38,222
42,61,185,185,164,161,798
42,57,160,149,114,131,653
13,23,51,51,44,44,226
22,27,84,91,73,106,403
6,6,20,19,17,19,87
28,55,145,154,123,107,612
16,33,68,63,54,62,296
40,67,189,192,159,156,803
41,53,161,167,144,152,718
19,29,85,102,87,92,414
37,60,160,163,142,148,710
25,40,94,104,97,77,437
43,63,187,210,169,166,838
25,37,80,81,74,89,386
37,64,146,149,133,153,682
37,55,160,166,145,157,720
36,58,163,158,136,149,700
34,52,149,183,147,150,715
29,37,110,121,101,100,498
44,64,166,180,144,129,727
29,39,90,97,96,93,444
20,37,107,99,101,105,469
28,39,105,116,89,101,478
38,57,162,180,143,149,729
47,67,200,210,175,174,873
39,59,178,200,165,169,810
46,55,157,160,142,157,717
51,71,207,212,167,168,876
51,66,199,198,167,166,847
45,71,180,197,161,172,826
53,67,187,191,163,167,828
49,58,151,158,145,166,727
47,62,171,167,150,152,749
44,55,142,147,135,133,656
45,56,162,161,151,162,737
53,70,209,208,163,175,878
45,67,186,206,161,167,832
0,37,71,83,46,0,237
14,57,144,130,82,45,472
30,49,171,175,131,132,688
40,54,138,152,124,126,634
40,54,138,152,124,126,634
19,27,55,57,71,60,289
50,69,190,183,154,162,808
23,38,103,109,93,85,451
38,59,138,135,114,123,607
0,44,72,79,36,0,231
56,74,185,196,170,183,864
45,67,164,163,143,161,743
48,67,200,208,171,185,879
52,62,194,192,169,179,848
53,66,195,202,162,163,841
43,67,183,189,156,185,823
41,66,184,181,155,152,779
24,33,69,70,70,75,341
11,21,58,50,47,53,240
22,25,68,74,63,58,310
47,68,163,162,150,165,755
37,47,127,117,96,86,510
19,26,74,76,64,62,321
15,24,65,59,53,60,276
22,27,77,81,67,69,343
48,68,204,205,162,143,830
48,60,189,187,150,143,777
50,63,178,192,162,172,817
30,42,95,97,76,75,415
44,58,161,156,145,158,722
44,63,188,212,158,156,821
46,60,194,210,187,172,869
40,56,147,142,130,146,661
34,41,124,123,107,102,531
34,43,120,128,102,101,528
36,53,160,172,149,151,721
47,52,157,161,138,149,704
46,61,187,192,156,159,801
13,21,56,65,48,44,247
16,22,44,55,46,39,222
29,39,112,113,104,113,510
48,61,161,173,135,167,745
44,65,176,189,161,152,787
40,51,144,147,142,126,650
32,51,132,151,119,129,614
34,51,138,155,124,125,627
37,47,144,156,135,137,656
39,65,171,149,131,138,693
16,27,60,61,50,49,263
41,44,141,145,118,119,608
37,50,151,148,126,127,639
15,18,54,61,61,57,266
38,59,146,149,135,140,667
2,5,7,7,8,3,32
54,73,183,181,166,177,834
11,14,33,37,33,43,171
34,50,125,126,122,119,576
38,55,144,141,117,122,617
36,52,133,138,114,108,581
38,63,141,158,138,138,676
38,63,141,158,138,138,676
20,35,86,88,69,70,368
47,58,166,159,127,129,686
32,52,135,129,111,132,591
40,53,147,151,141,120,652
33,38,127,129,106,103,536
32,44,109,123,116,104,528
22,38,82,87,68,76,373
45,63,169,178,155,162,772
34,52,135,151,134,152,658
19,22,60,53,44,37,235
15,19,68,66,56,51,275
27,25,73,86,77,66,354
22,35,92,93,80,99,421
52,69,199,198,164,165,847
42,64,189,183,158,154,790
45,63,174,183,146,149,760
36,53,155,153,128,120,645
7,39,84,71,57,55,313
42,55,173,183,135,134,722
48,66,164,158,137,137,710
30,36,94,115,104,84,463
32,41,115,127,109,107,531
47,60,177,186,157,175,802
17,28,68,72,65,80,330
20,31,92,94,77,59,373
29,31,80,99,84,90,413
7,5,4,6,7,6,35
39,55,152,167,147,137,697
30,40,109,102,86,101,468
30,43,113,111,99,112,508
31,43,108,125,110,113,530
4,4,5,6,5,7,31
6,10,12,14,10,11,63
28,39,119,139,123,129,577
1,1,1,5,5,2,15
49,62,181,190,154,159,795
46,61,165,179,154,164,769
11,20,42,37,31,35,176
4,4,1,4,4,10,27
3,4,7,11,10,6,41
2,3,5,5,2,2,19
22,36,93,83,64,89,387
40,59,167,152,141,135,694
20,31,78,71,56,67,323
20,17,69,67,56,55,284
32,37,93,93,85,84,424
41,66,190,199,164,164,824
33,57,148,154,124,115,631
47,69,198,198,169,184,865
26,29,81,103,80,66,385
15,18,78,89,72,73,345
17,24,70,63,53,74,301
13,27,50,50,44,38,222
28,43,97,85,72,92,417
19,27,66,57,38,48,255
34,37,120,120,89,101,501
3,6,6,6,4,4,29
17,25,64,61,53,66,286
4,5,3,7,4,6,29
20,28,76,89,91,87,391
25,41,105,102,77,96,446
26,34,89,91,83,70,393
29,32,66,67,71,71,336
26,33,94,108,99,91,451
41,53,152,159,124,126,655
1,2,1,3,3,4,14
18,29,68,79,49,46,289
5,8,17,15,15,15,75
44,53,133,134,113,119,596
42,65,186,199,158,166,816
43,59,163,163,133,139,700
43,63,179,183,153,164,785
28,40,79,77,65,85,374
50,66,203,193,156,163,831
48,59,192,206,168,163,836
48,66,192,190,158,179,833
49,72,191,187,162,162,823
15,61,119,112,84,70,461
15,22,59,64,54,59,273
45,71,188,190,174,180,848
32,46,155,158,136,131,658
