54,72,202,191,160,166,845
19,27,72,78,70,83,349
6,14,27,32,26,16,121
19,34,81,70,74,61,339
57,81,189,190,156,162,835
9,19,39,36,27,31,161
49,57,161,148,136,167,718
17,24,69,62,60,74,306
25,31,57,71,68,66,318
49,67,178,182,153,158,787
18,31,77,85,78,95,384
19,27,65,55,57,74,297
21,27,69,72,76,94,359
26,36,85,82,74,79,382
6,17,25,17,14,10,89
21,23,59,50,41,47,241
9,17,30,34,25,29,144
22,25,71,81,65,64,328
12,17,47,51,44,45,216
16,18,48,40,46,64,232
22,26,56,63,54,42,263
24,28,64,61,59,66,302
40,58,141,134,123,128,624
21,29,80,81,59,70,340
44,61,176,203,174,178,836
18,35,90,89,67,62,361
28,32,92,104,86,88,430
19,29,78,80,90,90,386
54,71,176,171,154,176,802
10,16,35,39,30,31,161
17,15,45,40,58,80,255
50,65,163,171,154,161,764
19,37,89,99,91,86,421
34,31,94,111,95,92,457
44,63,180,184,165,175,811
37,59,144,157,129,120,646
10,39,85,89,57,46,326
11,21,53,55,54,67,261
12,52,115,108,78,56,421
15,46,105,111,79,67,423
41,58,153,153,132,136,673
41,52,146,147,136,131,653
45,57,174,171,163,149,759
47,66,167,172,164,160,776
20,65,110,108,74,49,426
24,37,88,92,82,66,389
23,35,87,78,69,79,371
30,44,100,104,92,98,468
45,65,176,178,162,159,785
3,14,26,21,16,10,90
27,28,87,102,84,69,397
5,11,14,18,16,12,76
43,52,142,143,117,136,633
23,33,87,88,76,76,383
24,23,69,66,60,71,313
15,27,58,71,70,71,312
19,28,76,91,86,85,385
5,5,5,10,8,10,43
16,47,100,97,74,56,390
7,18,33,37,27,27,149
30,37,78,84,74,97,400
21,25,64,65,57,68,300
25,33,76,71,75,84,364
38,47,133,151,126,138,633
18,58,112,107,68,51,414
11,26,56,62,60,55,270
20,23,59,70,66,62,300
17,24,72,69,53,56,291
46,64,188,190,151,175,814
28,37,107,105,94,95,466
30,46,112,100,91,90,469
45,62,167,171,152,147,744
52,66,180,183,158,173,812
41,63,173,191,158,152,778
26,33,91,82,68,73,373
15,12,38,40,30,29,164
31,45,103,106,91,109,485
23,33,76,76,70,78,356
34,55,130,130,116,111,576
29,37,86,96,74,75,397
14,50,119,112,79,65,439
33,54,153,149,127,136,652
42,53,155,153,137,152,692
21,28,83,85,63,67,347
39,58,160,161,151,144,713
15,55,105,93,68,50,386
21,53,110,97,60,62,403
16,53,108,102,74,65,418
40,61,156,153,132,154,696
11,31,60,64,40,39,245
23,30,90,106,95,91,435
27,33,68,89,77,87,381
30,55,126,134,122,121,588
27,36,105,103,96,91,458
38,59,153,140,122,141,653
47,65,179,179,166,177,813
18,34,87,73,59,72,343
9,44,78,53,34,34,252
6,10,14,15,15,15,75
33,43,106,119,104,97,502
46,68,174,177,157,158,780
25,40,102,103,86,87,443
49,65,197,183,155,167,816
27,47,107,98,83,98,460
27,38,99,105,85,81,435
39,62,166,158,145,152,722
11,14,38,40,33,42,178
9,46,101,84,46,48,334
5,12,25,28,22,33,125
36,40,114,113,92,92,487
14,39,84,74,50,43,304
46,62,157,178,141,146,730
26,32,88,84,75,75,380
17,61,121,118,81,56,454
32,45,102,106,91,107,483
12,60,120,108,67,58,425
19,33,76,80,72,76,356
27,29,95,95,91,91,428
25,36,76,71,76,89,373
43,59,171,161,156,151,741
13,18,59,66,62,56,274
20,65,137,134,90,69,515
4,25,42,35,26,33,165
22,28,62,60,49,60,281
32,52,121,119,104,131,559
42,65,169,178,172,172,798
35,52,148,161,137,150,683
25,41,118,116,95,74,469
54,69,182,183,163,167,818
20,65,130,115,82,70,482
4,22,58,60,38,24,206
17,53,114,105,73,59,421
12,53,107,88,61,36,357
39,56,143,137,124,126,625
25,37,87,95,83,77,404
40,59,156,141,133,139,668
46,68,184,187,162,165,812
16,25,64,81,69,53,308
21,72,145,131,89,87,545
15,20,54,62,51,49,251
49,63,171,181,145,153,762
17,29,75,79,67,55,322
10,18,35,36,29,27,155
7,16,31,34,27,29,144
11,32,59,57,42,40,241
11,25,60,66,50,45,257
27,32,85,89,74,92,399
28,37,96,95,88,114,458
21,36,82,78,75,66,358
43,59,164,185,150,158,759
35,31,101,107,92,94,460
40,60,153,144,130,127,654
13,42,94,83,56,59,347
27,39,95,90,72,86,409
21,19,55,59,60,46,260
36,38,98,96,91,89,448
42,67,186,182,165,175,817
43,55,130,142,129,117,616
12,49,91,79,60,36,327
16,23,70,71,51,55,286
10,17,58,64,40,44,233
45,67,173,170,138,151,744
15,52,113,102,67,64,413
16,59,119,104,72,58,428
20,33,75,87,76,76,367
9,22,43,47,31,44,196
3,4,4,6,5,6,28
20,38,77,94,83,87,399
26,33,85,86,83,74,387
49,69,183,180,158,174,813
15,20,44,45,38,50,212
12,45,94,72,39,42,304
43,56,161,181,165,163,769
2,10,11,8,5,6,42
10,20,53,57,37,43,220
36,51,146,161,130,151,675
21,16,63,59,56,56,271
18,27,77,78,60,64,324
46,63,167,169,140,142,727
21,25,68,52,44,44,254
34,49,130,140,120,104,577
27,33,72,93,78,83,386
7,8,16,17,9,8,65
15,57,119,122,78,52,443
24,25,63,64,54,55,285
25,35,89,75,67,83,374
43,65,180,173,158,164,783
41,60,179,171,150,161,762
38,55,163,169,143,148,716
2,2,3,9,7,4,27
17,18,52,54,50,67,258
31,48,108,112,96,92,487
13,15,44,55,45,41,213
43,65,187,169,152,158,774
27,33,93,97,89,84,423
25,35,86,78,69,81,374
21,77,145,122,86,60,511
21,53,110,97,60,64,405
21,58,115,120,85,61,460
17,68,136,124,80,89,514
4,7,12,19,17,17,76
8,16,33,47,34,27,165
26,36,98,96,84,92,432
30,36,73,72,75,106,392
12,14,26,26,22,23,123
3,7,13,22,19,24,88
17,59,118,108,83,67,452
25,30,78,89,74,76,372
13,18,51,54,51,50,237
42,68,171,155,134,153,723
38,57,149,150,133,143,670
22,22,66,58,57,64,289
11,49,90,74,54,37,315
24,30,87,104,85,84,414
16,63,130,112,75,68,464
16,52,118,107,71,64,428
18,28,71,67,62,44,290
49,70,182,177,172,157,807
15,26,66,80,62,56,305
42,65,179,182,167,180,815
46,64,180,176,151,162,779
26,33,89,92,77,80,397
27,36,96,85,81,98,423
11,38,84,88,67,63,351
29,41,119,111,85,89,474
30,35,89,90,93,110,447
21,33,88,100,86,91,419
29,48,117,128,114,129,565
7,15,28,32,23,22,127
21,26,53,61,60,67,288
11,18,54,62,52,67,264
21,23,62,51,47,60,264
24,46,95,104,87,102,458
27,28,89,86,82,86,398
6,14,17,26,22,15,100
31,52,133,136,116,124,592
50,66,181,168,156,161,782
44,62,175,166,157,170,774
39,60,162,159,139,145,704
12,53,115,98,66,58,402
11,26,47,49,36,31,200
11,10,21,14,16,17,89
14,37,81,85,68,73,358
9,34,82,88,58,47,318
21,28,78,86,78,73,364
15,58,110,90,66,55,394
15,22,54,52,51,50,244
25,33,71,72,69,98,368
26,35,94,100,88,77,420
4,13,20,24,21,11,93
31,59,130,140,122,120,602
39,58,141,152,127,142,659
15,51,102,101,75,53,397
47,71,178,182,161,161,800
8,18,43,46,33,32,180
19,36,82,97,81,84,399
23,35,93,89,87,85,412
4,6,2,12,6,4,34
10,50,105,101,69,67,402
20,31,87,98,91,90,417
4,14,21,21,17,10,87
36,40,117,123,107,90,513
44,61,176,168,159,162,770
10,44,85,79,55,57,330
26,42,106,106,99,92,471
27,36,105,102,98,92,460
17,28,86,103,87,55,376
33,51,114,116,107,110,531
33,50,126,141,132,122,604
19,63,140,128,80,59,489
29,35,97,100,85,110,456
39,60,179,168,172,172,790
45,66,177,163,143,152,746
39,57,137,148,129,128,638
28,38,103,117,102,105,493
4,5,15,12,9,17,62
17,59,135,128,92,78,509
17,66,128,115,82,78,486
29,36,106,107,91,109,478
24,42,96,98,87,92,439
30,34,78,71,76,109,398
19,45,84,96,77,54,375
48,67,193,182,162,160,812
29,32,95,84,80,91,411
14,46,102,93,70,59,384
6,17,40,51,38,37,189
41,61,175,184,154,148,763
8,13,30,33,26,19,129
34,57,147,137,120,128,623
44,64,167,161,136,151,723
18,15,61,69,60,52,275
12,12,46,55,53,56,234
33,38,106,119,110,96,502
32,36,95,100,93,90,446
16,17,43,38,41,52,207
41,50,132,136,117,132,608
11,48,106,114,71,66,416
24,38,100,108,90,83,443
6,5,23,34,33,39,140
37,46,128,117,97,100,525
6,11,26,41,32,23,139
12,20,49,50,48,46,225
39,50,145,141,123,142,640
41,52,162,167,146,145,713
32,53,134,133,113,126,591
13,33,65,67,49,43,270
15,50,103,95,72,51,386
38,43,111,122,107,103,524
7,5,3,8,6,9,38
17,18,50,47,43,46,221
16,23,88,94,79,79,379
30,44,118,136,119,116,563
25,33,74,88,76,76,372
44,70,172,182,159,147,774
26,50,107,97,96,92,468
17,58,122,117,81,64,459
40,57,135,152,134,120,638
43,61,165,175,159,165,768
11,50,106,93,69,41,370
21,32,83,91,74,67,368
53,64,181,173,157,165,793
34,50,124,125,120,121,574
28,29,90,103,78,77,405
45,66,181,172,151,173,788
47,65,198,183,168,188,849
46,65,175,176,151,155,768
21,27,78,87,76,76,365
11,19,32,30,31,28,151
41,57,137,142,120,130,627
33,51,119,115,108,114,540
35,61,160,163,146,143,708
5,9,9,10,6,11,50
22,41,93,100,82,89,427
22,23,74,78,67,82,346
36,58,140,156,133,124,647
19,60,144,121,81,66,491
8,17,27,29,22,26,129
8,29,68,73,61,49,288
16,61,119,110,80,52,438
38,55,162,166,131,133,685
26,36,84,97,88,80,411
41,53,139,147,135,126,641
19,33,82,98,89,87,408
30,39,84,76,76,89,394
18,28,78,74,73,70,341
19,28,60,59,56,64,286
45,66,181,172,151,173,788
43,62,180,190,177,178,830
2,2,3,4,3,0,14
42,66,176,183,157,155,779
14,52,116,125,85,56,448
46,58,153,166,143,156,722
25,48,111,116,98,107,505
23,33,71,72,70,74,343
8,33,77,59,33,29,239
2,6,8,7,5,7,35
14,23,69,77,55,56,294
5,13,21,24,21,11,95
20,30,70,66,61,52,299
12,26,64,66,54,58,280
12,37,79,68,43,55,294
20,27,76,68,47,73,311
25,31,69,81,75,109,390
28,39,102,104,85,90,448
29,33,88,100,83,69,402
17,24,63,61,53,65,283
19,26,80,73,76,86,360
14,36,73,70,59,66,318
23,35,81,89,84,85,397
0,4,3,6,5,6,24
1,3,5,6,6,7,28
1,4,8,13,11,9,46
17,37,74,68,72,93,361
20,29,69,84,90,84,376
49,64,173,182,141,152,761
16,25,65,65,73,64,308
7,26,48,48,37,33,199
6,10,27,48,39,36,166
37,48,149,154,131,134,653
42,60,159,178,147,148,734
16,19,59,67,51,43,255
33,45,130,136,111,106,561
42,55,149,151,123,120,640
41,57,168,178,157,159,760
14,41,94,97,62,57,365
39,51,158,168,144,144,704
37,56,147,155,118,119,632
2,7,9,12,7,1,38
45,56,147,158,128,135,669
5,8,20,17,9,14,73
37,59,146,142,126,133,643
33,53,135,142,122,134,619
19,29,66,73,67,57,311
19,29,78,80,90,88,384
33,38,101,96,89,124,481
13,38,84,88,58,57,338
39,53,145,155,134,154,680
9,16,38,41,34,35,173
40,53,145,150,117,137,642
8,27,60,57,35,25,212
46,56,171,175,149,142,739
35,44,145,150,134,133,641
10,18,47,57,48,48,228
25,37,90,89,72,85,398
38,52,139,139,128,134,630
21,22,74,88,69,70,344
40,53,135,132,119,131,610
15,58,110,92,69,53,397
39,52,150,150,127,143,661
39,59,164,158,138,152,710
32,32,76,66,49,70,325
27,44,128,138,124,132,593
36,50,147,146,132,141,652
32,42,120,118,93,81,486
3,5,2,5,3,2,20
17,58,101,85,63,40,364
20,56,121,102,66,50,415
17,18,50,44,39,46,214
2,6,10,9,6,3,36
21,18,55,51,54,69,268
29,47,105,113,97,110,501
7,42,93,104,77,67,390
3,8,13,8,4,6,42
5,15,21,17,12,12,82
1,2,2,5,4,4,18
13,58,107,92,75,52,397
44,78,194,184,169,157,826
20,35,79,71,68,81,354
27,26,90,97,82,91,413
11,20,47,43,30,35,186
44,52,178,185,153,148,760
16,52,104,89,67,47,375
18,52,99,74,57,49,349
10,20,59,61,56,68,274
42,65,162,167,157,163,756
3,4,0,5,3,1,16
39,52,135,148,124,138,636
0,2,4,15,12,19,52
45,63,176,176,169,162,791
26,33,88,87,77,88,399
4,6,5,10,11,14,50
40,60,149,135,122,120,626
13,37,81,65,48,46,290
17,25,61,62,60,46,271
46,64,180,176,159,142,767
6,18,44,53,35,27,183
20,24,70,73,65,63,315
22,40,89,92,75,73,391
43,60,184,190,167,162,806
3,3,4,2,2,6,20
17,49,104,86,61,45,362
10,16,52,52,42,27,199
19,34,85,94,87,80,399
8,12,27,32,22,18,119
13,11,31,31,30,28,144
32,50,145,145,122,127,621
42,65,161,162,159,164,753
2,1,2,6,4,2,17
11,44,105,108,70,47,385
32,54,136,135,123,120,600
38,49,140,147,139,152,665
45,65,177,179,147,154,767
12,36,111,117,67,65,408
1,5,12,13,13,9,53
8,23,59,64,38,28,220
45,59,174,180,152,153,763
10,47,97,90,62,41,347
2,3,8,18,11,7,49
6,6,4,9,9,13,47
26,44,121,127,112,98,528
42,55,157,163,158,158,733
40,53,138,123,116,108,578
44,67,187,188,170,177,833
37,54,139,142,112,115,599
37,48,146,148,142,148,669
42,55,150,147,122,121,637
36,57,147,152,137,130,659
33,42,112,117,109,106,519
22,27,76,89,62,63,339
14,58,117,101,63,46,399
47,64,168,174,136,148,737
8,18,52,49,33,35,195
38,45,136,138,122,137,616
44,52,179,185,153,148,761
3,11,16,17,13,4,64
14,26,61,66,70,74,311
5,9,18,25,21,12,90
34,55,148,160,138,143,678
20,63,125,118,92,72,490
1,2,2,5,3,0,13
31,53,147,153,134,147,665
12,42,93,91,56,50,344
50,65,186,193,161,184,839
1,1,0,2,2,2,8
30,38,102,118,105,94,487
28,32,97,96,94,101,448
44,57,171,170,145,151,738
12,18,31,37,35,21,154
23,28,77,79,69,78,354
43,49,129,148,119,120,608
45,63,185,186,163,148,790
20,28,70,70,77,83,348
41,51,146,153,139,135,665
3,9,12,11,10,10,55
38,52,160,162,121,129,662
39,51,154,155,119,123,641
45,60,161,163,153,149,731
2,1,3,2,2,6,16
38,60,177,178,167,158,778
41,67,186,190,160,165,809
42,64,170,177,138,139,730
43,59,172,170,139,148,731
3,2,5,9,5,4,28
1,3,2,1,2,1,10
14,27,63,49,36,28,217
12,15,40,44,47,37,195
33,46,120,121,112,121,553
40,63,158,177,143,145,726
1,3,2,2,2,2,12
44,52,153,162,132,150,693
16,55,102,79,60,51,363
46,61,173,177,148,154,759
22,46,106,118,110,96,498
38,55,141,152,131,150,667
4,7,6,8,7,15,47
39,59,166,169,140,152,725
3,14,22,13,12,16,80
14,55,125,121,82,63,460
37,52,162,164,132,139,686
22,32,71,69,75,76,345
33,49,138,146,127,131,624
23,34,87,94,77,82,397
41,66,185,181,166,159,798
3,8,17,30,22,12,92
35,55,137,120,103,117,567
22,30,85,79,65,75,356
26,35,75,72,63,78,349
37,50,140,132,119,132,610
15,46,88,77,54,41,321
37,50,145,153,134,137,656
44,62,170,191,163,164,794
5,41,80,72,46,41,285
39,52,171,163,142,154,721
19,39,82,96,88,97,421
35,50,139,127,115,120,586
4,11,16,17,17,18,83
44,67,167,161,140,134,713
13,45,92,78,70,55,353
29,33,99,98,82,87,428
17,52,113,99,66,46,393
1,2,9,15,8,12,47
38,54,163,175,140,146,716
38,56,152,158,127,145,676
0,5,5,2,1,0,13
14,31,61,76,69,51,302
24,29,85,83,66,74,361
23,31,88,81,71,70,364
14,53,109,130,89,61,456
14,23,54,57,47,37,232
8,15,50,49,35,31,188
23,59,143,137,99,87,548
23,28,70,71,67,61,320
29,87,195,180,130,107,728
1,1,1,2,1,1,7
2,3,2,3,2,2,14
31,39,114,120,99,108,511
23,65,150,151,105,78,572
23,80,170,143,107,102,625
26,47,103,112,93,86,467
24,37,97,105,84,86,433
24,28,68,71,61,62,314
18,68,132,133,89,67,507
11,21,49,43,33,32,189
2,2,4,4,3,4,19
11,18,45,52,35,29,190
1,4,6,2,2,2,17
8,17,42,43,31,25,166
14,67,126,123,95,69,494
28,95,190,167,122,92,694
16,27,74,64,58,74,313
16,64,147,118,86,75,506
12,49,101,87,63,37,349
9,19,53,47,37,29,194
3,7,5,5,4,3,27
10,21,47,50,33,36,197
13,26,81,89,71,73,353
25,40,93,96,86,84,424
2,8,17,16,12,8,63
5,5,3,12,9,6,40
23,36,88,100,94,83,424
21,25,69,74,71,69,329
22,36,78,86,90,98,410
7,16,48,58,29,36,194
18,56,117,118,85,60,454
18,29,78,90,70,66,351
12,39,91,85,65,53,345
25,77,166,162,114,102,646
5,6,8,11,10,8,48
23,43,96,90,69,73,394
1,1,1,5,4,4,16
25,75,170,165,116,100,651
1,2,7,7,5,17,39
23,62,142,135,103,79,544
30,35,96,101,89,92,443
8,21,49,54,37,37,206
14,45,105,95,64,40,363
22,63,152,132,100,79,548
27,84,175,167,128,85,666
15,23,56,64,66,70,294
0,0,1,3,2,2,8
28,40,96,97,86,80,427
31,28,70,75,78,79,361
10,20,51,55,42,37,215
19,34,86,86,76,94,395
21,23,67,62,55,52,280
25,37,92,104,85,91,434
20,30,94,114,99,89,446
27,81,175,163,116,82,644
12,30,81,90,53,38,304
27,40,96,93,85,91,432
13,47,112,118,74,54,418
24,32,82,87,69,75,369
22,84,177,158,108,79,628
25,40,92,98,88,90,433
13,16,57,70,44,44,244
24,29,82,77,61,72,345
9,12,26,31,26,32,136
13,22,60,67,41,38,241
12,10,23,22,20,24,111
5,8,6,7,6,9,41
24,21,61,57,52,60,275
21,91,196,180,142,100,730
18,45,107,127,80,69,446
8,14,48,48,28,35,181
1,3,1,2,4,4,15
27,87,193,176,124,99,706
4,5,2,5,3,5,24
2,1,1,3,3,2,12
14,49,102,80,52,46,343
10,17,55,67,44,37,230
25,74,165,164,114,83,625
5,7,9,9,5,8,43
16,51,109,113,76,59,424
21,65,145,133,100,82,546
21,33,82,97,91,86,410
19,51,107,110,73,66,426
18,24,74,69,70,76,331
8,18,46,53,31,30,186
16,82,177,180,130,96,681
31,35,117,115,105,118,521
1,3,5,9,6,0,24
0,2,2,1,2,6,13
13,49,104,109,70,59,404
17,33,88,86,64,58,346
26,27,79,88,76,74,370
32,54,116,122,100,109,533
4,8,3,6,7,6,34
11,17,49,52,34,35,198
26,30,77,75,81,93,382
18,53,107,100,78,60,416
9,13,47,47,33,28,177
7,16,41,45,37,24,170
23,66,155,143,105,70,562
2,4,2,3,5,5,21
2,3,1,2,2,2,12
24,76,161,139,99,83,582
25,34,84,77,63,70,353
0,1,1,3,4,4,13
27,43,115,113,89,101,488
27,90,182,176,134,98,707
27,38,87,91,87,99,429
2,3,1,1,1,3,11
1,2,2,5,6,4,20
4,5,6,8,5,5,33
10,30,65,54,40,41,240
9,12,32,38,26,27,144
14,45,104,95,70,43,371
27,72,153,140,104,69,565
6,13,33,37,39,16,144
8,14,42,37,25,27,153
8,11,36,37,33,34,159
7,7,3,2,2,2,23
34,34,106,117,95,114,500
2,4,2,4,6,5,23
6,17,35,33,16,18,125
14,35,86,69,53,45,302
17,22,54,61,57,66,277
10,11,23,25,13,19,101
12,8,20,25,23,15,103
23,39,108,104,92,99,465
4,4,2,3,2,3,18
3,4,0,5,3,1,16
24,76,179,163,114,87,643
27,40,112,114,105,114,512
5,5,3,12,9,6,40
28,38,88,107,93,92,446
24,77,170,156,115,81,623
33,35,90,103,82,73,416
1,3,2,4,4,1,15
20,25,64,71,67,76,323
11,16,41,42,36,30,176
26,75,154,143,96,77,571
6,14,42,43,33,22,160
23,69,148,129,90,79,538
8,14,52,45,31,30,180
11,24,57,58,40,39,229
23,77,168,153,104,70,595
13,53,108,107,67,59,407
28,86,200,177,119,90,700
11,23,59,59,38,35,225
21,22,65,55,37,52,252
18,21,72,73,57,47,288
8,37,89,96,62,38,330
18,84,163,151,112,85,613
4,5,6,8,7,10,40
18,27,59,42,38,48,232
22,29,93,113,87,92,436
15,27,97,84,66,83,372
38,53,150,163,139,143,686
22,21,60,50,49,64,266
43,62,158,166,153,169,751
3,3,2,5,4,8,25
14,14,34,32,23,16,133
10,11,35,43,35,30,164
27,33,90,93,90,83,416
28,38,102,96,88,86,438
20,23,66,73,68,69,319
22,35,84,99,92,83,415
38,52,147,156,144,135,672
26,39,97,108,95,92,457
33,48,115,119,98,116,529
28,39,106,109,93,88,463
30,38,90,94,84,86,422
4,2,6,15,10,9,46
46,62,163,160,146,142,719
29,37,113,110,84,89,462
35,70,180,177,142,129,733
2,4,4,4,4,2,20
18,32,79,69,63,85,346
21,31,76,87,80,90,385
26,39,120,117,93,96,491
16,23,45,58,65,61,268
21,39,104,103,83,83,433
39,62,156,151,149,149,706
40,50,141,126,116,139,612
40,57,144,146,139,140,666
35,46,117,117,89,101,505
40,56,156,156,133,122,663
42,54,158,158,142,129,683
35,54,139,137,116,126,607
42,55,146,136,142,150,671
29,91,196,167,123,89,695
0,0,0,2,1,1,4
34,48,119,123,116,117,557
18,28,67,70,64,63,310
2,3,4,5,4,2,20
25,77,180,175,120,92,669
31,58,142,142,121,124,618
33,51,127,127,116,121,575
13,18,49,58,50,41,229
45,59,148,161,141,143,697
36,49,130,144,127,133,619
25,38,114,116,111,124,528
10,14,23,23,24,16,110
41,59,155,138,112,122,627
19,26,83,76,75,74,353
23,36,89,101,85,84,418
5,9,9,12,8,13,56
19,28,66,77,63,63,316
35,57,135,129,113,125,594
36,49,140,142,132,137,636
33,54,145,145,116,130,623
12,13,27,31,28,29,140
36,50,151,143,137,150,667
5,3,0,2,1,4,15
43,59,156,153,129,143,683
26,29,104,105,89,89,442
22,42,112,131,113,90,510
35,45,140,132,107,113,572
47,63,176,176,158,162,782
26,39,96,118,110,93,482
18,23,67,70,58,59,295
6,9,12,12,12,19,70
1,4,3,6,4,0,18
41,67,162,161,149,148,728
0,1,2,5,3,4,15
39,51,146,150,128,126,640
15,35,76,82,71,66,345
30,40,119,132,116,102,539
35,44,118,137,124,100,558
20,21,68,78,65,81,333
34,47,132,133,116,124,586
36,47,119,122,105,101,530
16,13,57,44,35,32,197
28,33,96,98,88,95,438
1,1,1,2,0,0,5
39,54,152,153,134,124,656
39,58,161,169,150,153,730
40,61,149,156,132,143,681
31,51,125,140,124,122,593
27,44,94,100,82,96,443
30,45,105,133,112,110,535
9,19,55,55,47,45,230
35,41,132,134,108,118,568
37,45,145,160,130,121,638
6,7,13,16,9,11,62
30,91,176,168,123,83,671
9,19,54,53,51,58,244
39,53,144,134,130,128,628
51,66,173,175,154,171,790
3,3,1,4,4,4,19
15,28,52,43,48,56,242
29,37,98,100,84,76,424
2,3,3,2,3,2,15
6,6,4,6,6,4,32
24,35,112,120,98,88,477
38,47,140,145,138,120,628
42,57,171,162,150,156,738
39,58,155,150,123,140,665
30,40,118,129,119,104,540
37,51,138,129,121,128,604
30,40,118,130,115,102,535
23,27,72,66,71,87,346
36,46,130,149,128,109,598
18,32,102,112,101,100,465
7,4,7,5,0,2,25
36,54,149,140,127,129,635
41,58,138,140,138,145,660
45,52,172,152,138,145,704
29,42,113,129,97,106,516
30,40,118,127,116,110,541
5,17,46,48,47,53,216
9,8,24,29,19,15,104
27,39,93,104,82,108,453
25,37,96,90,73,75,396
39,49,125,133,116,118,580
31,45,113,132,111,106,538
49,62,161,167,147,149,735
23,39,94,88,71,82,397
38,54,144,143,136,123,638
34,51,120,130,114,109,558
1,0,0,7,6,2,16
31,41,127,127,116,119,561
48,62,176,172,151,164,773
33,92,184,162,115,105,691
36,62,138,139,117,134,626
29,41,119,121,114,108,532
1,3,4,6,5,4,23
0,2,3,4,3,1,13
31,50,127,136,122,124,590
34,39,111,131,122,114,551
12,17,42,45,41,22,179
21,31,79,70,67,84,352
48,68,177,176,165,159,793
26,37,112,107,87,106,475
38,53,151,157,140,148,687
3,3,5,8,3,5,27
31,81,186,194,135,97,724
38,55,139,135,128,134,629
37,54,113,126,116,104,550
6,23,41,37,21,29,157
0,1,4,6,4,1,16
7,21,30,34,27,35,154
5,19,40,44,26,36,170
5,12,22,19,10,8,76
0,37,67,60,43,0,207
0,35,60,61,35,0,191
0,29,53,58,31,0,171
0,36,65,59,40,0,200
0,31,54,51,33,0,169
0,12,14,14,10,0,50
0,16,28,26,16,0,86
0,31,46,48,30,0,155
0,22,38,43,27,0,130
0,28,45,49,32,0,154
0,18,30,31,20,0,99
0,4,5,9,5,0,23
0,6,10,8,8,0,32
0,33,50,54,37,0,174
0,2,3,1,0,0,6
0,30,53,55,31,0,169
0,0,0,2,1,0,3
0,31,47,57,36,0,171
0,28,44,50,33,0,155
0,25,41,53,34,0,153
0,0,0,1,0,0,1
0,22,36,40,23,0,121
0,30,44,56,37,0,167
0,31,48,52,31,0,162
0,5,6,6,3,0,20
0,31,45,49,31,0,156
0,22,38,34,20,0,114
0,27,47,58,37,0,169
0,2,3,4,3,0,12
0,28,48,54,31,0,161
0,30,49,51,34,0,164
0,0,0,1,1,0,2
0,24,35,39,23,0,121
0,22,32,27,19,0,100
0,24,37,41,25,0,127
0,24,41,46,31,0,142
0,29,48,49,31,0,157
0,24,41,46,31,0,142
0,23,38,42,26,0,129
0,28,42,52,37,0,159
0,32,48,49,28,0,157
0,29,45,48,32,0,154
0,8,10,7,6,0,31
0,38,50,55,39,0,182
0,32,41,47,30,0,150
0,38,56,58,36,0,188
0,28,38,37,25,0,128
0,36,48,52,32,0,168
0,0,1,0,0,0,1
0,31,43,47,32,0,153
0,38,56,58,36,0,188
0,30,43,46,30,0,149
0,8,12,18,15,0,53
0,7,14,21,11,0,53
0,33,48,52,35,0,168
0,30,39,44,32,0,145
0,13,18,17,17,0,65
0,33,45,51,35,0,164
0,6,4,5,5,0,20
0,19,26,31,26,0,102
0,32,47,58,38,0,175
0,36,45,47,34,0,162
0,6,8,8,7,0,29
0,0,0,1,0,0,1
0,11,18,24,14,0,67
0,14,24,27,20,0,85
0,31,43,50,35,0,159
0,7,10,9,8,0,34
0,1,2,3,1,0,7
0,22,29,36,26,0,113
0,7,10,11,9,0,37
0,25,39,44,31,0,139
0,1,2,3,2,0,8
11,16,36,45,34,34,176
47,65,165,177,176,159,789
24,39,84,82,72,91,392
9,17,35,37,29,29,156
37,55,144,155,136,134,661
39,59,156,164,149,159,726
51,68,183,175,146,163,786
44,58,174,186,156,165,783
43,63,169,174,148,152,749
31,50,108,117,97,103,506
13,25,40,36,29,43,186
50,72,189,199,171,175,856
6,10,25,40,31,23,135
41,49,140,152,132,136,650
45,56,166,161,146,149,723
50,72,189,199,172,175,857
54,76,188,207,179,164,868
47,65,185,184,147,160,788
46,70,182,167,144,160,769
9,18,26,34,23,20,130
7,20,43,39,24,31,164
7,18,39,43,31,29,167
44,60,169,175,146,167,761
11,12,28,33,27,18,129
55,73,187,187,148,160,810
40,60,160,162,143,164,729
42,65,174,199,172,172,824
48,67,179,202,164,185,845
12,19,44,55,40,43,213
44,60,160,163,155,139,721
47,69,183,201,173,185,858
30,48,112,124,102,92,508
49,61,176,190,164,176,816
10,19,33,44,36,29,171
9,22,40,44,33,32,180
30,45,126,136,123,103,563
36,49,144,148,135,147,659
46,65,177,185,156,163,792
42,58,147,145,130,146,668
27,30,88,105,84,75,409
18,65,126,123,84,69,485
25,42,97,92,80,108,444
42,51,165,168,149,147,722
12,19,32,42,36,28,169
38,63,162,167,150,141,721
35,51,143,160,139,142,670
9,14,29,38,32,29,151
42,51,165,168,148,144,718
43,69,167,173,158,162,772
49,61,178,194,159,180,821
52,69,186,197,151,171,826
44,61,171,178,144,169,767
46,62,163,166,151,154,742
11,18,32,41,35,29,166
47,64,177,179,162,153,782
45,67,166,173,158,158,767
53,73,183,193,172,181,855
17,28,78,87,67,55,332
12,19,40,49,38,29,187
49,67,175,189,158,157,795
48,69,191,187,153,164,812
10,18,34,32,27,31,152
45,69,179,175,153,168,789
47,61,167,167,139,134,715
49,71,182,169,147,165,783
52,69,195,202,164,181,863
38,60,148,159,131,123,659
3,4,6,7,4,3,27
48,66,180,201,163,167,825
45,62,187,182,150,166,792
47,66,165,176,168,168,790
44,61,179,186,160,164,794
45,59,169,185,154,153,765
52,67,189,188,157,163,816
41,57,161,171,135,135,700
38,63,154,166,159,148,728
33,41,90,105,96,100,465
57,80,180,206,175,181,879
31,38,93,96,89,72,419
42,59,149,153,134,134,671
44,55,149,153,140,153,694
48,74,184,197,174,175,852
50,61,174,186,156,175,802
8,18,39,49,34,32,180
43,62,159,163,145,144,716
46,69,165,196,162,173,811
44,69,171,178,157,156,775
10,11,30,44,33,34,162
13,23,46,39,35,37,193
20,27,77,87,65,87,363
40,61,150,162,149,158,720
19,31,66,63,52,50,281
36,53,140,149,137,136,651
44,65,164,159,146,159,737
41,61,172,166,136,139,715
33,59,146,155,128,136,657
15,19,48,55,48,42,227
51,63,184,181,146,163,788
18,35,76,78,66,83,356
33,48,127,120,103,117,548
43,59,152,168,147,144,713
46,61,182,188,164,155,796
55,76,185,205,179,162,862
22,30,79,76,64,73,344
42,75,171,173,148,163,772
48,69,197,213,170,181,878
42,55,147,158,141,170,713
41,57,161,163,138,144,704
40,58,156,163,136,146,699
32,56,142,156,121,124,631
11,22,41,43,31,39,187
53,63,187,197,171,172,843
29,56,131,139,125,129,609
42,63,165,166,150,159,745
12,18,37,32,30,26,155
26,39,87,90,79,84,405
52,70,187,211,175,178,873
54,74,188,208,178,161,863
49,68,179,189,160,166,811
12,18,37,34,22,32,155
38,60,147,146,125,146,662
50,69,173,184,162,156,794
5,15,27,35,35,30,147
7,12,29,33,27,26,134
48,67,172,180,143,179,789
40,69,179,202,174,170,834
11,24,40,46,39,32,192
46,72,179,186,168,162,813
42,55,174,171,146,136,724
47,63,176,181,165,174,806
45,65,179,180,159,164,792
51,65,184,201,172,171,844
33,49,143,139,133,122,619
3,30,53,67,52,6,211
43,75,202,207,168,171,866
39,63,187,191,156,164,800
24,50,119,138,127,86,544
42,64,176,189,147,143,761
19,31,86,97,77,68,378
0,0,5,4,1,2,12
0,3,9,7,4,7,30
49,71,200,207,174,175,876
47,67,184,206,194,169,867
49,74,181,186,163,154,807
40,63,190,189,167,180,829
18,23,73,74,72,80,340
45,67,189,186,150,162,799
46,67,196,204,174,186,873
47,71,193,198,163,171,843
45,67,183,192,183,167,837
50,75,193,204,167,180,869
46,75,212,202,163,178,876
41,70,179,189,160,170,809
46,68,199,198,163,173,847
52,70,186,186,156,164,814
53,71,185,185,156,164,814
41,70,179,189,160,170,809
45,69,187,194,175,174,844
40,64,190,192,171,187,844
0,0,0,1,2,1,4
48,60,193,204,171,166,842
52,70,189,195,164,167,837
47,70,200,198,167,160,842
43,62,173,191,164,151,784
45,67,192,194,159,176,833
41,61,195,187,166,182,832
45,68,188,204,162,175,842
38,58,190,174,164,158,782
40,67,183,196,169,174,829
44,65,187,197,169,176,838
54,72,198,196,169,164,853
43,72,199,200,155,178,847
44,62,196,203,164,178,847
42,64,200,209,163,178,856
44,64,182,187,172,178,827
44,73,176,178,167,160,798
8,11,27,47,33,31,157
17,55,97,99,76,68,412
23,75,176,163,110,86,633
14,19,61,66,42,39,241
10,21,54,50,36,30,201
31,45,111,109,99,116,511
18,17,44,39,56,72,246
10,19,49,56,39,37,210
23,38,90,79,88,83,401
21,75,156,139,98,71,560
22,25,91,108,82,81,409
30,43,112,109,98,105,497
32,51,148,152,136,139,658
55,67,174,180,163,157,796
22,34,83,83,86,100,408
44,60,158,164,140,139,705
22,34,91,86,80,67,380
43,61,164,163,149,150,730
44,62,169,168,153,164,760
42,68,192,214,170,154,840
41,53,167,167,156,157,741
468,1222,2465,2478,2748,2223,11604
40,52,146,136,114,124,612
44,61,158,170,149,156,738
16,31,71,88,83,77,366
16,26,62,77,61,76,318
45,65,197,200,166,162,835
49,62,179,167,154,160,771
15,32,78,76,61,62,324
26,38,109,110,87,97,467
25,33,84,81,72,80,375
44,66,185,192,170,171,828
25,30,71,68,64,59,317
36,48,130,124,110,116,564
49,72,192,192,177,170,852
44,57,171,168,147,144,731
45,62,159,166,164,158,754
16,25,67,72,67,69,316
379,921,1868,1870,2123,1656,8817
26,41,96,101,90,103,457
50,61,186,187,172,182,838
36,55,145,149,132,140,657
24,31,96,98,85,92,426
30,28,81,61,56,88,344
18,37,92,102,92,87,428
24,32,92,94,69,78,389
42,57,141,138,131,149,658
24,38,105,108,104,111,490
50,70,202,194,159,158,833
20,18,60,61,58,58,275
23,28,95,98,76,61,381
35,56,163,168,136,123,681
24,34,107,111,93,107,476
30,42,125,124,112,103,536
42,67,179,181,163,147,779
41,63,184,221,172,156,837
15,20,69,79,66,61,310
33,36,105,113,98,106,491
27,34,99,102,97,89,448
47,52,153,163,133,125,673
47,67,182,185,162,156,799
22,28,83,82,69,69,353
49,61,194,181,164,158,807
46,70,176,177,164,168,801
48,64,186,194,173,169,834
53,69,192,188,155,160,817
46,67,207,201,165,170,856
32,39,127,132,115,123,568
30,52,140,148,121,132,623
34,49,141,151,144,133,652
37,43,124,123,114,104,545
20,24,72,78,70,69,333
38,53,145,142,116,123,617
28,43,113,112,98,109,503
16,31,67,69,66,77,326
38,41,97,108,112,112,508
53,75,191,189,152,164,824
18,30,71,74,63,77,333
44,59,175,184,166,162,790
9,18,58,65,50,59,259
53,63,170,176,152,139,753
39,53,144,140,115,125,616
28,36,91,95,84,96,430
32,47,116,111,99,93,498
29,51,131,136,115,107,569
45,67,163,162,141,152,730
41,57,158,170,141,134,701
33,49,139,153,133,140,647
32,56,148,140,125,111,612
28,43,109,118,111,106,515
21,33,82,87,77,80,380
35,44,140,141,118,125,603
35,50,134,138,130,149,636
37,59,166,171,146,146,725
44,55,168,176,151,143,737
33,62,148,146,125,135,649
34,35,106,107,105,105,492
46,65,181,171,143,158,764
40,61,176,172,148,158,755
47,70,186,200,177,160,840
25,39,86,92,73,85,400
49,60,180,187,168,158,802
39,58,179,181,163,158,778
38,55,141,156,133,128,651
37,52,145,139,129,138,640
18,34,85,93,70,64,364
19,33,81,88,75,78,374
32,41,99,97,90,108,467
36,49,128,137,118,123,591
31,47,144,170,144,151,687
44,65,193,196,167,162,827
5,2,4,5,5,7,28
25,41,125,115,108,117,531
32,51,130,131,120,127,591
32,61,149,150,132,135,659
35,47,129,118,111,119,559
27,41,106,103,99,101,477
40,51,148,141,126,145,651
30,44,106,101,83,104,468
30,37,115,112,99,110,503
31,44,104,101,92,101,473
3,3,3,7,7,5,28
29,40,128,144,125,119,585
36,53,146,148,123,149,655
41,67,189,175,142,157,771
35,46,110,121,106,113,531
30,41,104,104,96,106,481
24,39,129,114,105,102,513
25,36,93,105,95,84,438
33,53,147,150,135,136,654
22,34,71,69,65,60,321
19,33,79,81,71,81,364
16,31,79,69,61,64,320
23,30,67,56,50,60,286
26,41,100,100,93,89,449
36,43,122,124,99,98,522
50,63,189,195,163,160,820
50,64,179,182,161,170,806
12,17,36,50,58,73,246
38,58,196,221,170,160,843
38,55,133,128,130,129,613
46,58,169,161,149,165,748
44,68,193,190,167,168,830
36,51,139,145,123,129,623
37,52,150,157,140,130,666
48,61,202,212,179,164,866
996,2719,5414,5453,6120,4705,25407
36,49,121,116,107,114,543
43,64,178,194,165,158,802
48,67,191,202,167,171,846
49,61,182,197,166,161,816
43,64,194,200,166,166,833
44,72,199,192,169,168,844
3,4,3,8,6,8,32
39,52,140,151,136,142,660
47,57,179,203,171,153,810
42,67,171,182,147,155,764
36,46,116,126,105,111,540
31,63,151,150,120,117,632
47,66,168,168,149,161,759
37,53,131,135,130,145,631
49,64,172,177,156,168,786
43,60,189,202,197,179,870
42,68,178,189,167,163,807
34,46,127,134,107,111,559
0,40,64,68,39,0,211
42,49,136,127,109,122,585
40,59,146,163,147,145,700
24,59,139,138,113,104,577
45,60,172,173,156,163,769
35,61,156,155,136,148,691
44,68,194,203,162,155,826
48,66,197,200,174,174,859
37,51,140,139,120,132,619
40,62,183,177,157,137,756
39,47,131,124,115,131,587
47,70,180,195,171,164,827
49,69,207,190,154,160,829
122,212,493,493,655,465,2440
24,47,116,104,94,125,510
45,61,184,199,162,155,806
43,57,158,152,137,142,689
44,62,168,173,149,154,750
33,45,121,130,118,127,574
31,48,118,126,119,128,570
46,67,179,196,170,167,825
49,59,187,206,176,175,852
19,20,52,59,47,38,235
42,58,197,198,180,167,842
43,66,164,166,155,163,757
45,65,197,193,166,180,846
41,58,183,204,159,174,819
32,51,126,122,109,110,550
42,62,172,179,159,160,774
42,61,159,188,157,143,750
47,55,175,175,156,158,766
48,64,180,209,162,170,833
52,67,187,193,164,162,825
0,36,61,59,37,0,193
44,54,158,169,142,145,712
42,70,191,190,171,178,842
43,58,157,162,147,143,710
31,54,133,133,117,110,578
10,38,81,96,75,29,329
40,61,171,172,152,164,760
42,64,176,192,162,166,802
33,51,131,131,115,117,578
38,43,108,113,105,107,514
41,58,155,160,135,152,701
30,41,108,120,109,112,520
32,41,108,111,99,108,499
34,45,128,138,123,129,597
42,62,182,189,154,178,807
37,54,124,136,132,120,603
42,54,154,163,123,151,687
45,69,180,182,153,155,784
39,59,151,152,127,143,671
50,70,199,214,168,159,860
46,68,191,174,160,168,807
32,50,110,141,125,109,567
39,49,138,141,103,102,572
45,62,163,172,159,163,764
0,31,60,75,43,0,209
44,75,190,188,154,162,813
17,61,150,139,106,76,549
28,42,110,128,111,107,526
46,69,203,214,180,187,899
11,28,56,65,50,49,259
10,56,120,113,66,41,406
12,27,60,68,45,46,258
40,61,164,173,159,153,750
2,36,74,65,50,9,236
0,42,68,73,42,0,225
13,24,57,74,55,53,276
35,41,121,119,101,103,520
33,48,129,118,104,118,550
36,49,128,155,133,138,639
51,69,167,173,159,162,781
39,54,142,152,129,135,651
18,64,144,136,84,58,504
13,22,66,65,50,47,263
40,72,198,202,166,159,837
24,41,115,128,104,79,491
0,34,71,61,38,0,204
17,22,61,75,60,46,281
14,24,55,65,52,55,265
15,22,55,73,60,52,277
46,64,165,178,149,152,754
40,67,160,171,144,146,728
42,62,148,162,138,143,695
33,48,111,120,111,114,537
32,98,231,210,154,117,842
21,66,147,142,99,88,563
13,40,96,99,76,45,369
14,21,61,68,44,42,250
20,49,142,146,108,102,567
13,22,57,74,50,36,252
14,26,56,71,52,46,265
49,66,173,184,163,170,805
43,65,168,176,144,157,753
0,35,67,70,48,0,220
32,106,235,225,168,131,897
19,23,62,72,51,40,267
24,47,121,143,119,126,580
46,57,158,166,146,153,726
41,52,149,164,140,149,695
43,68,168,183,147,160,769
36,54,130,132,117,137,606
37,59,159,177,144,148,724
0,34,67,73,40,0,214
43,68,160,172,148,151,742
47,66,189,193,149,157,801
34,60,138,158,129,131,650
44,62,164,174,157,163,764
15,22,62,63,46,39,247
13,19,57,71,55,46,261
0,29,61,72,43,0,205
16,23,67,74,63,47,290
42,54,145,155,135,138,669
10,33,95,97,54,50,339
31,95,207,188,143,121,785
1,41,76,65,46,11,240
42,58,152,162,138,136,688
28,39,82,89,65,65,368
10,21,55,57,43,43,229
13,21,53,68,51,49,255
40,52,144,144,123,121,624
47,70,176,178,152,156,779
33,52,123,125,111,119,563
33,53,143,145,115,115,604
37,61,160,173,142,152,725
46,65,166,169,152,159,757
35,50,115,125,117,109,551
33,102,245,234,159,115,888
37,55,160,156,135,149,692
46,81,186,191,158,173,835
42,62,148,162,138,143,695
18,21,58,58,50,69,274
27,91,221,202,160,115,816
35,83,206,203,147,128,802
28,83,195,183,129,96,714
46,67,175,179,160,158,785
30,43,115,145,122,128,583
28,85,200,198,144,97,752
17,19,62,80,40,40,258
44,68,169,174,151,172,778
45,64,169,182,149,150,759
19,32,78,84,67,69,349
47,67,167,173,142,161,757
43,65,160,166,148,150,732
4,37,67,77,51,25,261
36,43,128,128,109,115,559
51,58,156,172,157,166,760
9,23,47,54,49,43,225
44,50,149,169,142,153,707
0,43,68,78,48,0,237
51,74,176,187,157,169,814
0,32,52,77,49,0,210
13,23,62,74,49,48,269
12,23,48,61,43,47,234
32,50,143,140,137,130,632
32,44,101,111,97,121,506
0,37,62,75,47,0,221
0,40,71,82,45,0,238
15,27,72,60,43,47,264
11,24,54,71,49,50,259
0,36,70,75,43,0,224
46,71,208,222,174,185,906
26,45,113,121,111,119,535
0,37,81,72,47,0,237
49,69,202,201,156,160,837
13,18,52,55,51,50,239
25,34,92,99,95,91,436
0,35,72,77,46,0,230
40,63,165,173,145,158,744
21,28,81,104,76,73,383
51,67,159,163,151,169,760
44,67,173,184,164,166,798
1,36,65,75,46,11,234
0,36,68,72,45,0,221
49,73,168,175,153,160,778
40,54,139,149,127,146,655
35,45,109,122,97,126,534
23,50,128,118,96,92,507
7,40,66,71,51,23,258
35,53,122,137,118,124,589
43,58,162,175,139,147,724
34,53,122,130,119,120,578
0,39,66,54,39,0,198
34,50,125,129,116,106,560
50,70,192,198,158,178,846
14,23,55,65,52,53,262
17,22,55,63,43,50,250
23,35,78,89,83,65,373
20,33,71,88,70,73,355
49,72,190,178,158,160,807
46,73,183,188,163,163,816
14,21,44,48,37,38,202
44,77,170,164,143,155,753
44,69,187,183,167,168,818
14,20,57,62,54,42,249
10,29,56,65,46,49,255
9,17,33,43,39,39,180
46,68,183,171,148,162,778
48,66,184,192,166,177,833
10,20,46,52,36,38,202
36,62,183,178,152,144,755
31,51,148,141,104,118,593
10,18,38,39,28,31,164
13,18,45,48,32,37,193
11,19,44,58,49,42,223
10,24,60,75,63,58,290
10,19,46,54,42,59,230
15,24,60,66,42,46,253
47,68,198,196,173,196,878
56,73,199,203,178,198,907
14,28,57,67,43,52,261
50,72,184,188,167,175,836
41,60,156,157,136,143,693
50,75,197,203,168,176,869
45,69,182,185,160,154,795
13,18,48,56,44,41,220
13,19,46,44,30,34,186
12,20,48,57,45,49,231
13,26,51,61,51,48,250
50,72,184,188,167,175,836
14,25,51,55,45,51,241
14,25,51,55,44,50,239
27,42,112,121,111,129,542
44,65,191,182,158,170,810
47,72,203,212,167,174,875
7,16,39,46,37,28,173
12,26,48,72,52,50,260
11,18,44,53,42,46,214
49,67,192,188,152,167,815
12,25,60,58,40,44,239
49,75,208,222,175,194,923
25,42,125,126,111,99,528
30,48,136,137,110,118,579
12,19,44,48,43,40,206
47,67,178,181,169,179,821
44,66,192,188,169,175,834
52,71,201,213,188,177,902
55,72,210,202,161,177,877
42,64,185,180,157,164,792
48,71,193,183,165,173,833
15,32,63,67,48,52,277
53,71,198,189,178,188,877
44,68,174,194,173,165,818
38,61,186,185,159,161,790
28,41,107,111,98,110,495
47,74,205,202,164,176,868
13,25,45,52,43,49,227
26,39,118,118,98,105,504
46,68,184,189,166,171,824
44,69,185,179,164,188,829
13,26,52,60,45,43,239
54,78,203,209,181,178,903
13,26,56,57,40,40,232
12,21,45,53,43,38,212
42,65,160,166,149,153,735
43,72,187,196,163,175,836
47,68,184,192,159,177,827
19,31,88,93,81,74,386
15,33,60,71,48,47,274
43,67,183,181,164,161,799
46,68,167,167,143,159,750
44,74,189,191,152,166,816
51,72,183,192,175,195,868
11,20,33,46,44,32,186
11,18,46,51,36,41,203
14,21,45,53,40,49,222
12,22,48,57,49,43,231
10,20,42,55,43,43,213
43,61,182,188,169,194,837
14,18,63,69,51,50,265
27,52,115,109,97,86,486
42,63,197,196,162,162,822
8,23,41,46,39,42,199
45,70,183,186,160,155,799
16,29,49,63,43,41,241
10,20,39,42,35,44,190
41,67,187,202,153,165,815
54,68,202,219,188,183,914
11,23,45,61,46,43,229
27,43,114,123,102,92,501
27,34,102,106,90,93,452
10,24,43,46,36,43,202
14,20,45,47,42,43,211
31,55,129,127,112,117,571
45,74,186,187,164,170,826
29,53,144,149,123,130,628
15,29,64,72,59,58,297
11,21,43,50,41,32,198
14,35,59,67,46,52,273
11,22,46,52,42,42,215
48,66,181,194,161,169,819
33,44,124,116,105,115,537
45,76,193,186,159,169,828
40,67,189,199,157,176,828
45,64,170,166,160,170,775
41,63,163,164,145,152,728
45,66,173,185,164,177,810
42,70,180,187,159,166,804
48,66,166,187,162,169,798
51,68,193,192,172,174,850
7,24,43,49,40,43,206
10,17,38,42,33,27,167
50,66,177,187,146,142,768
50,71,185,213,174,169,862
55,73,211,211,176,173,899
52,76,195,200,175,179,877
50,68,179,193,159,153,802
48,68,186,182,164,175,823
44,64,180,191,156,160,795
44,67,184,194,165,169,823
14,25,63,66,46,52,266
34,53,135,144,133,126,625
50,72,198,197,167,180,864
10,21,44,53,46,43,217
9,18,40,51,37,40,195
10,20,44,51,38,37,200
43,73,178,193,163,164,814
50,68,198,202,165,176,859
42,68,176,174,153,173,786
46,72,182,174,153,171,798
48,75,196,208,161,172,860
48,69,193,210,179,185,884
40,72,156,174,148,159,749
51,70,177,179,150,172,799
10,18,32,38,27,30,155
11,20,39,46,32,31,179
51,61,187,192,161,169,821
46,74,196,203,163,176,858
9,19,43,52,44,39,206
53,74,203,200,164,172,866
40,62,182,191,158,163,796
45,65,180,193,174,169,826
50,69,188,200,170,179,856
12,21,45,48,38,31,195
43,58,154,168,154,148,725
10,22,48,48,36,41,205
44,76,183,194,161,170,828
55,81,209,200,173,171,889
9,19,42,48,39,36,193
53,63,180,190,172,169,827
48,69,185,193,164,167,826
47,73,174,190,163,169,816
51,75,193,199,176,186,880
49,71,170,189,157,159,795
10,21,44,52,44,42,213
49,67,200,208,164,158,846
56,68,198,193,173,171,859
43,73,176,186,150,163,791
47,71,182,181,158,173,812
53,72,204,207,172,170,878
55,84,203,219,178,170,909
48,69,195,213,182,188,895
43,67,188,207,172,176,853
48,74,177,194,161,169,823
12,24,42,46,37,39,200
47,74,193,190,162,173,839
51,76,206,203,181,192,909
51,65,186,192,162,173,829
46,65,184,188,154,185,822
11,19,33,43,35,30,171
51,68,203,219,186,180,907
10,16,46,53,40,36,201
13,18,49,49,46,42,217
53,68,180,209,189,183,882
35,52,131,146,117,101,582
48,66,181,176,159,164,794
37,47,131,142,116,115,588
17,23,61,60,53,63,277
15,30,74,72,72,70,333
13,51,93,85,60,51,353
29,45,130,136,110,131,581
39,50,144,138,116,126,613
44,67,189,185,177,170,832
30,55,140,138,113,120,596
40,60,150,135,122,120,627
39,54,165,163,130,139,690
27,44,127,137,124,132,591
7,9,26,32,24,23,121
13,53,94,104,77,52,393
19,31,85,90,66,54,345
32,33,98,108,86,98,455
22,74,169,164,115,87,631
0,1,3,3,1,3,11
30,70,153,167,130,125,675
38,61,154,151,132,139,675
30,41,111,115,86,101,484
30,43,109,124,108,101,515
47,69,180,172,142,143,753
0,28,45,52,34,0,159
47,57,181,177,171,175,808
44,61,163,147,141,155,711
32,45,127,127,108,115,554
36,42,126,123,112,139,578
35,49,133,141,118,116,592
26,34,106,95,65,74,400
39,49,138,133,108,137,604
38,60,170,169,156,138,731
38,45,129,127,112,111,562
4,6,3,10,5,4,32
39,51,140,166,143,146,685
18,29,79,84,69,52,331
29,32,83,94,81,70,389
25,31,85,79,73,83,376
22,36,101,84,82,97,422
2,3,3,4,1,5,18
37,52,139,137,131,133,629
43,57,161,174,155,155,745
26,40,112,118,97,99,492
30,39,131,136,122,132,590
26,36,124,126,105,87,504
25,30,89,101,83,89,417
26,30,83,88,68,81,376
30,42,104,117,102,93,488
39,58,152,151,139,139,678
34,48,120,115,90,117,524
33,41,118,108,89,107,496
31,47,128,123,119,131,579
29,39,95,104,92,81,440
39,55,146,128,123,128,619
26,44,118,116,106,115,525
44,56,161,162,140,137,700
36,50,156,173,151,144,710
33,45,130,125,110,114,557
42,60,162,150,135,140,689
42,55,153,154,141,146,691
3,4,2,4,2,1,16
13,17,46,64,64,64,268
34,52,149,148,125,131,639
18,21,57,54,56,60,266
44,64,150,146,135,157,696
37,51,138,141,126,120,613
44,65,164,167,145,128,713
47,61,170,172,145,147,742
45,63,166,163,155,162,754
23,35,98,100,89,85,430
45,63,175,191,163,160,797
27,45,111,95,90,103,471
48,67,191,171,160,163,800
33,38,114,126,101,104,516
16,29,72,71,77,78,343
23,34,76,81,84,87,385
37,55,160,163,144,146,705
32,40,130,130,111,111,554
41,55,146,145,123,138,648
36,43,137,127,129,131,603
35,52,146,130,110,113,586
1,1,3,5,3,0,13
28,34,76,76,78,94,386
41,50,135,139,136,138,639
38,54,159,154,138,154,697
27,38,111,117,95,104,492
41,65,158,168,149,140,721
26,34,91,87,82,110,430
39,65,188,180,162,158,792
4,6,5,7,5,1,28
42,53,165,173,162,161,756
40,57,145,146,136,141,665
26,41,129,130,114,119,559
42,56,150,150,139,133,670
32,55,132,127,121,122,589
40,58,170,173,152,163,756
43,61,147,140,123,137,651
43,52,170,164,146,137,712
30,46,100,96,92,79,443
29,42,102,99,83,87,442
47,61,176,171,147,161,763
31,45,133,151,120,125,605
29,39,101,103,90,91,453
44,62,165,164,140,137,712
41,62,169,178,159,163,772
25,36,97,102,83,90,433
15,21,63,56,55,42,252
41,55,170,171,146,134,717
43,55,154,153,145,148,698
14,22,58,48,45,59,246
36,46,151,151,129,119,632
26,32,88,90,77,89,402
19,24,77,86,77,64,347
28,36,83,77,86,97,407
51,67,187,197,189,183,874
47,69,187,203,166,151,823
52,64,199,201,174,183,873
0,37,61,65,40,0,203
27,47,111,122,104,122,533
38,49,122,146,126,126,607
24,26,75,72,57,53,307
45,69,202,201,161,165,843
48,58,196,192,169,167,830
20,32,90,93,71,77,383
48,66,187,195,154,164,814
46,64,182,193,163,158,806
28,40,97,97,87,81,430
42,61,188,190,165,161,807
44,64,185,185,152,171,801
47,65,172,185,161,185,815
0,28,60,63,41,0,192
44,63,183,180,160,178,808
50,62,179,195,173,157,816
39,54,131,139,132,138,633
45,65,166,169,153,160,758
43,65,175,191,157,161,792
0,39,67,73,50,0,229
31,52,128,143,115,124,593
49,72,176,158,149,171,775
0,34,65,78,47,0,224
49,61,161,171,160,163,765
46,71,199,199,166,152,833
48,69,177,172,159,160,785
47,67,198,184,164,160,820
38,51,131,149,139,133,641
43,59,160,164,140,153,719
55,74,207,187,166,154,843
45,62,172,186,164,169,798
46,61,159,161,142,162,731
0,35,59,68,47,0,209
44,61,164,170,150,160,749
42,67,195,189,172,175,840
0,32,59,76,41,0,208
55,70,186,186,158,171,826
46,66,169,188,158,166,793
40,60,153,147,124,133,657
45,72,202,210,181,168,878
49,66,189,207,169,167,847
0,39,64,66,50,0,219
42,56,154,177,154,151,734
0,34,49,72,43,0,198
44,63,152,163,148,166,736
0,32,54,75,42,0,203
32,54,147,138,113,130,614
47,71,199,205,168,162,852
47,63,173,183,151,156,773
42,78,197,205,170,183,875
37,57,145,163,133,133,668
46,62,196,191,169,170,834
49,70,195,196,159,166,835
40,60,150,147,126,138,661
0,37,66,67,50,0,220
47,65,171,180,154,165,782
0,37,68,58,48,0,211
39,59,156,155,133,149,691
0,35,56,74,47,0,212
0,38,67,77,46,0,228
39,72,194,192,159,154,810
51,69,201,196,163,172,852
47,70,147,158,136,160,718
52,64,149,161,150,143,719
47,69,188,195,172,165,836
35,47,129,130,129,125,595
47,65,170,180,154,165,781
39,52,149,157,133,134,664
0,0,0,1,1,0,2
50,70,187,208,183,180,878
21,36,103,107,90,81,438
37,52,118,122,112,108,549
38,52,142,158,138,141,669
49,60,161,177,153,147,747
56,66,201,198,166,167,854
55,132,285,285,300,245,1302
39,58,157,153,132,124,663
36,56,146,134,111,122,605
39,52,135,149,125,110,610
17,27,77,61,58,73,313
41,64,169,174,158,147,753
22,27,66,66,65,66,312
16,23,71,87,70,65,332
30,36,106,114,88,92,466
40,58,157,153,134,135,677
37,54,137,141,134,119,622
33,43,130,133,106,100,545
43,66,186,181,161,150,787
44,63,189,173,160,151,780
36,56,156,145,122,138,653
32,48,126,136,120,122,584
40,50,160,150,130,121,651
34,53,144,145,115,125,616
34,55,138,147,127,123,624
31,41,102,107,98,93,472
40,41,137,142,132,126,618
27,43,123,116,106,124,539
30,44,124,128,126,119,571
36,50,135,143,123,122,609
42,61,161,155,136,142,697
33,49,125,117,101,115,540
21,26,72,51,54,45,269
36,61,154,157,135,125,668
33,42,137,131,107,113,563
23,31,89,96,86,94,419
47,68,187,186,168,146,802
29,36,89,81,82,94,411
43,50,154,159,146,151,703
45,62,166,152,145,149,719
38,50,130,139,125,142,624
24,38,117,107,94,109,489
21,39,111,89,82,90,432
26,34,88,111,102,92,453
28,35,103,97,76,83,422
19,33,83,86,73,74,368
18,31,87,85,76,73,370
23,33,81,85,77,68,367
23,33,81,85,77,68,367
21,28,73,81,76,90,369
17,23,68,72,59,50,289
23,29,74,70,60,63,319
1,3,3,4,3,1,15
24,24,68,63,55,62,296
21,25,64,65,57,66,298
39,56,147,148,118,111,619
1,4,6,4,1,0,16
23,32,108,129,104,98,494
28,34,95,90,78,92,417
26,38,90,84,87,102,427
23,35,79,74,81,95,387
22,25,81,77,59,52,316
37,49,147,156,138,152,679
25,35,87,105,102,98,452
28,46,132,132,123,112,573
32,43,104,103,105,101,488
15,26,59,71,57,40,268
26,36,111,117,100,111,501
19,25,66,69,62,38,279
1,2,1,2,2,3,11
15,29,54,57,53,43,251
17,30,67,72,66,61,313
46,61,192,181,152,149,781
54,62,184,183,164,174,821
39,57,169,165,143,137,710
26,26,80,64,59,66,321
25,25,64,60,57,57,288
25,25,64,60,57,57,288
45,66,194,202,176,163,846
48,68,177,185,171,158,807
42,61,183,189,156,155,786
51,61,187,190,159,156,804
48,64,180,179,166,166,803
43,53,168,180,145,170,759
49,68,180,188,167,168,820
44,66,184,189,169,173,825
44,67,181,185,164,170,811
33,43,125,121,104,123,549
50,69,186,181,160,146,792
34,52,134,140,123,107,590
39,47,137,147,123,121,614
36,58,156,158,127,136,671
14,25,71,84,72,67,333
36,48,134,142,129,129,618
48,61,164,178,147,140,738
34,40,106,110,94,98,482
31,45,125,126,107,102,536
36,45,117,114,107,118,537
36,45,117,114,108,118,538
41,51,148,151,137,125,653
37,50,148,165,135,134,669
22,35,106,98,89,93,443
23,26,72,77,67,69,334
36,59,156,165,136,133,685
39,49,143,154,138,149,672
42,58,169,161,133,141,704
37,56,155,157,132,127,664
47,67,195,196,181,171,857
54,67,184,198,165,166,834
22,39,93,105,80,99,438
23,33,92,97,91,87,423
52,74,177,181,151,151,786
56,75,183,180,161,167,822
23,31,88,91,82,99,414
29,43,111,117,113,124,537
31,40,113,108,89,108,489
36,45,120,103,94,96,494
53,70,194,196,182,173,868
37,48,152,144,140,142,663
40,61,158,159,135,128,681
54,67,169,172,160,140,762
30,42,121,115,98,94,500
28,48,123,116,114,115,544
37,58,160,169,147,154,725
37,50,141,149,131,142,650
30,38,86,94,85,92,425
36,46,127,140,121,118,588
29,32,90,98,95,93,437
40,49,144,142,108,114,597
35,52,143,151,118,126,625
40,60,162,163,130,131,686
44,57,175,185,157,168,786
32,52,151,150,134,146,665
56,66,188,193,164,155,822
49,63,185,192,163,176,828
45,64,189,186,162,179,825
46,65,178,185,165,171,810
33,44,125,139,114,128,583
46,69,198,185,174,165,837
44,75,200,197,161,163,840
43,62,171,181,162,156,775
44,67,172,164,151,147,745
41,60,164,168,137,146,716
48,74,204,205,166,170,867
42,60,166,162,148,147,725
39,57,152,146,142,133,669
52,71,189,207,168,151,838
44,63,173,180,159,151,770
37,50,152,147,130,131,647
45,69,177,193,175,173,832
42,68,195,196,167,158,826
39,58,162,158,142,155,714
43,56,165,178,150,134,726
30,46,121,119,107,119,542
35,44,141,139,109,109,577
29,42,115,122,110,115,533
41,58,177,192,174,157,799
42,57,188,180,158,165,790
47,71,193,198,166,159,834
36,57,138,136,127,135,629
31,45,116,113,104,117,526
47,65,179,195,170,166,822
48,68,195,199,166,153,829
46,67,210,203,169,156,851
41,66,181,183,152,144,767
41,66,181,183,152,144,767
43,62,177,170,144,157,753
51,67,187,202,167,161,835
51,64,182,193,158,166,814
57,66,183,207,167,173,853
50,66,192,173,136,158,775
48,61,177,182,166,168,802
47,65,189,208,172,173,854
40,42,104,110,109,114,519
47,66,191,209,171,163,847
28,45,113,102,84,84,456
46,70,204,202,178,168,868
49,63,197,200,167,160,836
41,65,171,171,155,164,767
44,68,197,196,171,177,853
35,54,145,150,131,133,648
41,64,186,193,177,179,840
39,63,188,190,170,170,820
52,66,206,200,169,173,866
47,67,203,193,171,169,850
44,62,191,188,185,166,836
22,22,59,63,57,53,276
45,53,173,174,167,168,780
44,64,199,204,167,179,857
47,71,194,206,177,182,877
45,61,196,193,164,165,824
43,60,185,199,184,186,857
44,63,183,199,181,168,838
44,61,163,163,146,152,729
40,56,149,174,155,150,724
48,58,162,159,149,146,722
44,69,198,204,176,152,843
44,64,164,195,156,139,762
46,70,191,202,159,164,832
44,57,170,166,138,145,720
50,65,171,184,159,157,786
47,69,185,210,172,181,864
32,50,141,130,124,121,598
48,66,188,195,158,156,811
48,63,183,181,161,159,795
42,64,179,176,151,152,764
46,69,173,178,156,160,782
34,49,148,142,119,143,635
34,51,137,137,114,119,592
9,21,61,66,44,47,248
47,67,206,196,170,152,838
413,1032,2112,2111,2371,1877,9916
33,50,129,130,120,117,579
34,52,117,127,112,117,559
53,71,188,192,162,169,835
35,58,152,153,140,142,680
32,46,125,145,126,139,613
37,50,146,149,129,133,644
43,59,159,174,151,148,734
37,50,137,144,143,136,647
40,53,155,152,132,137,669
36,60,152,147,121,150,666
42,53,151,160,145,151,702
44,56,162,157,133,152,704
44,54,158,169,142,143,710
19,21,67,74,71,72,324
30,41,116,114,99,101,501
27,33,106,106,88,95,455
32,41,118,117,96,102,506
23,40,105,113,105,129,515
25,45,109,112,104,129,524
34,47,140,133,116,118,588
29,35,97,114,92,91,458
41,61,200,197,161,169,829
43,69,196,197,157,181,843
42,61,190,200,162,167,822
35,55,156,151,144,122,663
41,56,160,178,154,166,755
46,62,162,174,149,162,755
28,40,104,117,104,105,498
27,38,93,105,91,102,456
46,68,194,199,161,174,842
43,65,193,202,168,153,824
41,63,206,198,162,152,822
27,29,86,76,56,64,338
46,60,187,204,175,182,854
46,69,191,200,170,153,829
50,65,179,186,154,163,797
46,72,189,210,169,161,847
45,66,191,196,165,173,836
43,73,211,208,163,182,880
48,65,188,185,167,168,821
47,65,163,182,152,160,769
42,63,181,179,164,170,799
493,1302,2651,2693,2909,2213,12261
356,787,1642,1639,1733,1328,7485
44,68,188,188,162,177,827
0,35,60,72,40,0,207
36,51,143,150,135,133,648
0,36,61,67,34,0,198
0,34,57,68,34,0,193
0,37,61,65,36,0,199
0,34,55,64,33,0,186
42,63,167,182,152,155,761
30,59,149,149,123,114,624
45,69,193,192,170,160,829
41,63,177,192,174,167,814
38,56,143,153,128,134,652
42,79,188,199,156,165,829
0,35,56,63,38,0,192
50,57,162,167,146,152,734
44,61,151,160,141,154,711
39,60,156,160,139,135,689
38,64,156,162,144,156,720
46,70,193,215,182,173,879
43,64,198,199,165,158,827
47,62,151,163,136,158,717
48,62,155,175,161,160,761
47,63,157,163,135,145,710
39,59,161,175,148,150,732
43,54,155,154,141,152,699
33,50,130,142,136,133,624
36,58,160,148,123,153,678
42,54,167,164,139,159,725
44,65,191,201,169,166,836
46,64,162,164,144,151,731
42,72,160,166,145,179,764
46,64,182,191,167,163,813
40,67,185,196,168,160,816
40,53,182,182,167,157,781
38,58,180,187,163,165,791
41,63,188,191,165,177,825
47,64,191,197,161,173,833
44,66,204,210,165,164,853
42,75,184,203,174,173,851
45,67,202,205,167,181,867
47,70,194,207,167,161,846
51,73,208,209,164,163,868
0,31,55,67,42,0,195
0,31,55,68,43,0,197
0,38,72,68,52,0,230
47,65,192,194,173,171,842
47,75,193,211,181,160,867
41,66,194,203,170,162,836
44,68,182,195,165,173,827
50,70,203,213,174,164,874
46,60,167,183,161,160,777
39,60,190,188,156,160,793
42,51,140,136,134,134,637
42,68,177,171,141,152,751
45,65,172,183,144,152,761
45,73,190,181,151,169,809
45,73,190,181,151,169,809
44,65,177,182,163,169,800
55,68,196,193,162,160,834
46,69,194,204,167,151,831
48,62,158,173,162,154,757
41,68,167,178,161,154,769
50,70,167,174,154,148,763
40,50,140,159,149,152,690
51,71,201,199,161,187,870
49,62,171,187,161,181,811
50,61,168,178,150,160,767
49,73,187,188,151,161,809
26,43,82,83,86,78,398
31,50,142,157,126,126,632
41,58,157,170,148,163,737
35,44,131,135,125,112,582
27,53,121,137,118,118,574
38,51,148,144,131,142,654
50,78,188,204,175,162,857
47,73,187,191,164,169,831
43,57,154,165,149,136,704
51,66,158,163,146,148,732
53,67,184,187,159,162,812
43,64,199,196,159,169,830
36,68,204,207,157,165,837
35,49,121,130,100,120,555
33,50,127,144,125,118,597
43,62,181,193,176,151,806
38,55,135,144,125,130,627
36,55,129,144,130,140,634
34,45,129,137,115,119,579
0,35,57,61,34,0,187
0,34,66,75,38,0,213
46,67,195,199,165,159,831
45,69,196,199,161,172,842
43,71,204,207,159,172,856
45,68,206,201,157,158,835
45,68,206,201,157,158,835
44,67,210,203,163,172,859
41,62,170,189,163,158,783
47,66,185,195,165,152,810
50,70,199,208,169,175,871
24,47,102,102,102,74,451
51,74,208,200,165,178,876
41,55,153,158,140,132,679
45,64,189,186,158,167,809
29,42,93,91,79,86,420
0,33,62,60,45,0,200
0,33,57,73,53,0,216
48,68,189,202,164,172,843
0,35,62,72,43,0,212
0,35,63,79,45,0,222
30,47,149,147,124,119,616
13,23,81,91,62,50,320
18,25,83,84,69,54,333
37,44,153,157,142,131,664
0,32,69,61,44,0,206
0,36,58,67,44,0,205
44,64,187,190,168,177,830
47,62,179,208,186,169,851
19,20,70,74,60,71,314
49,65,157,166,146,151,734
48,70,176,185,163,158,800
0,33,68,73,48,0,222
0,36,66,70,53,0,225
0,36,68,72,51,0,227
0,34,57,74,46,0,211
0,37,68,75,44,0,224
0,36,77,70,43,0,226
49,69,198,210,180,172,878
0,33,59,68,47,0,207
49,70,215,206,174,179,893
44,68,198,212,176,161,859
37,61,169,183,156,144,750
40,54,167,171,147,127,706
0,33,60,64,45,0,202
42,64,182,187,165,161,801
32,49,130,130,117,118,576
46,66,177,187,158,176,810
49,74,185,191,157,166,822
13,21,52,67,54,47,254
45,70,198,196,165,170,844
51,71,188,184,151,174,819
46,62,165,168,143,155,739
48,68,176,177,157,151,777
27,45,123,133,107,88,523
21,37,104,113,82,80,437
36,59,149,166,137,145,692
49,69,178,185,161,167,809
34,55,126,117,97,96,525
11,26,59,74,50,50,270
18,27,85,95,70,70,365
15,33,73,84,73,73,351
9,20,43,53,42,43,210
0,36,72,83,45,0,236
12,25,51,62,46,52,248
35,58,141,146,131,143,654
21,29,71,77,79,85,362
38,55,150,143,122,133,641
45,70,168,171,155,163,772
2,35,64,74,46,10,231
39,88,210,200,168,155,860
21,49,121,133,98,76,498
3,41,74,71,39,8,236
50,64,171,165,143,167,760
47,67,187,201,162,172,836
0,37,74,82,43,0,236
16,24,59,77,48,48,272
30,43,108,106,91,98,476
39,58,139,151,133,151,671
24,42,107,99,77,59,408
1,29,53,67,43,4,197
52,72,199,204,173,177,877
46,70,186,206,171,177,856
54,74,198,205,164,186,881
15,22,48,58,49,54,246
16,17,55,58,46,52,244
11,17,40,42,27,31,168
12,20,38,45,34,47,196
53,72,196,205,181,171,878
38,62,165,168,146,160,739
13,19,57,49,51,57,246
14,27,50,60,44,52,247
51,68,179,199,167,176,840
33,36,116,113,102,110,510
54,74,216,215,178,179,916
52,77,204,193,172,186,884
17,19,59,77,54,42,268
2,2,2,5,4,4,19
26,41,118,115,91,100,491
30,42,96,108,98,109,483
47,68,191,201,183,188,878
45,70,178,189,154,172,808
47,66,191,201,154,172,831
48,72,192,194,173,170,849
42,63,187,184,167,168,811
8,22,46,56,38,43,213
42,68,200,192,164,173,839
41,65,196,194,171,172,839
49,70,190,199,172,187,867
53,79,201,209,171,181,894
45,75,185,183,149,165,802
45,69,194,190,160,161,819
49,64,189,193,158,178,831
10,22,45,53,39,41,210
44,71,196,207,182,181,881
43,58,169,177,148,145,740
41,62,156,165,153,150,727
50,72,188,197,170,180,857
45,67,168,174,154,146,754
11,17,36,49,41,29,183
48,72,194,202,171,176,863
9,21,35,43,37,43,188
50,74,190,200,171,177,862
46,73,204,201,173,168,865
43,73,193,197,171,173,850
54,72,210,212,166,177,891
9,16,30,40,35,29,159
49,72,191,208,166,198,884
10,15,35,39,35,36,170
14,21,51,51,40,37,214
9,18,39,43,38,38,185
10,17,35,41,30,41,174
6,17,41,44,31,38,177
32,50,122,125,109,118,556
55,66,187,193,170,190,861
34,54,134,138,121,117,598
49,68,179,174,157,168,795
47,63,185,183,149,169,796
53,67,185,200,163,170,838
46,75,194,189,161,169,834
48,71,200,185,157,172,833
46,74,196,203,164,177,860
28,40,98,93,83,87,429
7,15,30,31,26,25,134
46,71,170,191,152,154,784
48,58,180,192,170,171,819
47,67,180,184,143,173,794
47,64,177,191,158,164,801
47,69,165,171,154,153,759
46,68,180,180,158,158,790
13,24,39,45,31,31,183
12,23,45,40,26,28,174
46,69,191,198,177,163,844
13,19,35,42,31,33,173
42,60,148,146,121,143,660
12,21,41,46,42,45,207
9,19,39,41,37,35,180
53,64,187,195,159,170,828
25,43,101,101,90,86,446
46,57,176,201,169,173,822
44,64,169,185,162,157,781
50,62,168,179,154,143,756
42,66,181,173,163,177,802
47,65,168,171,146,167,764
48,63,166,175,154,165,771
36,40,117,123,107,90,513
35,49,127,132,111,123,577
44,58,161,168,148,151,730
45,58,155,176,151,164,749
7,20,40,62,49,30,208
23,30,79,78,67,73,350
18,32,82,82,69,80,363
11,40,90,97,71,51,360
18,53,104,96,61,62,394
42,66,180,193,161,160,802
44,60,164,164,151,154,737
37,66,152,164,140,142,701
12,17,36,46,29,20,160
16,45,112,99,64,55,391
11,18,58,65,39,35,226
23,65,151,142,109,84,574
14,29,78,90,75,84,370
5,5,10,11,6,6,43
28,42,107,103,99,103,482
42,54,153,155,144,146,694
3,4,3,4,3,3,20
47,55,168,159,150,139,718
0,1,2,5,4,2,14
34,46,127,130,100,97,534
0,1,0,3,3,0,7
0,25,39,38,25,0,127
0,32,47,52,33,0,164
34,53,134,139,122,107,589
32,53,160,159,150,151,705
33,32,100,114,103,97,479
22,32,99,116,101,109,479
51,59,178,168,156,154,766
18,31,75,68,58,70,320
23,35,98,102,81,90,429
35,54,161,157,128,119,654
48,68,204,203,177,172,872
9,17,43,47,34,37,187
20,26,62,62,61,73,304
25,26,74,88,85,90,388
42,59,161,173,142,156,733
44,62,168,178,140,141,733
33,43,122,114,109,106,527
36,58,142,135,118,119,608
44,61,177,180,167,156,785
39,67,196,196,177,173,848
33,51,152,152,144,145,677
42,51,158,171,133,152,707
37,41,119,108,96,119,520
31,42,114,117,100,106,510
50,66,176,179,148,164,783
52,76,178,176,152,161,795
49,68,194,200,164,154,829
44,53,154,173,141,138,703
40,62,163,162,149,156,732
48,61,173,187,168,156,793
51,69,185,199,170,160,834
52,68,195,189,160,162,826
50,64,167,175,151,176,783
42,56,164,168,136,139,705
32,56,147,144,112,112,603
31,53,149,157,133,140,663
35,56,146,152,140,126,655
25,30,100,113,102,96,466
39,53,143,150,129,134,648
0,33,66,63,44,0,206
0,35,61,71,40,0,207
0,37,66,78,51,0,232
42,62,180,200,165,159,808
0,33,58,64,35,0,190
0,37,66,67,45,0,215
44,66,180,180,171,168,809
48,65,184,219,173,160,849
7,34,78,87,61,40,307
15,39,91,93,75,48,361
51,70,170,174,143,165,773
28,40,106,118,106,108,506
42,66,197,215,180,183,883
26,46,111,135,121,122,561
14,18,53,70,58,44,257
11,46,104,117,93,52,423
15,23,56,71,47,43,255
12,20,54,71,55,56,268
0,36,60,70,46,0,212
14,21,53,62,52,38,240
14,25,46,50,41,48,224
37,53,140,156,147,140,673
11,39,82,86,60,45,323
8,23,50,50,33,45,209
41,63,173,188,156,159,780
34,52,150,152,121,128,637
13,19,44,48,37,50,211
26,29,89,83,77,84,388
5,4,15,22,26,16,88
33,47,139,136,127,113,595
17,19,56,64,60,50,266
44,61,177,172,156,161,771
39,54,150,152,141,148,684
31,29,85,89,84,96,414
43,59,156,170,159,134,721
23,26,81,87,92,90,399
47,66,176,185,169,165,808
25,30,87,88,80,75,385
34,60,163,157,138,133,685
40,51,145,161,142,144,683
43,58,156,171,142,140,710
40,62,163,161,148,156,730
30,42,127,115,100,101,515
43,61,165,163,148,147,727
18,33,88,100,96,103,438
24,41,109,119,114,91,498
33,40,119,112,98,112,514
39,59,162,179,152,146,737
46,65,194,198,175,166,844
39,62,194,212,169,169,845
45,59,162,152,135,151,704
44,70,212,201,178,184,889
42,75,191,185,161,171,825
48,64,190,199,165,161,827
47,66,191,185,159,164,812
41,54,154,171,153,152,725
42,69,158,167,159,151,746
41,56,142,143,120,128,630
39,59,165,165,141,160,729
46,67,197,207,165,169,851
49,72,182,186,169,148,806
0,33,67,78,43,0,221
7,59,129,126,85,42,448
33,60,153,155,138,133,672
38,47,135,147,132,139,638
38,47,135,147,132,139,638
17,17,54,68,53,56,265
42,63,179,195,151,170,800
26,36,101,104,88,92,447
38,50,121,145,115,126,595
0,43,67,80,44,0,234
48,74,194,193,159,178,846
45,59,171,166,144,157,742
47,64,188,195,172,183,849
52,72,194,203,164,186,871
50,71,199,205,172,168,865
48,71,179,191,158,177,824
43,62,173,172,152,152,754
15,28,63,61,53,67,287
12,19,37,47,52,65,232
14,27,78,78,66,53,316
46,69,169,172,158,157,771
27,39,126,144,98,105,539
21,24,69,75,60,62,311
18,25,76,62,56,59,296
23,28,70,76,80,81,358
50,72,190,199,167,163,841
50,58,184,173,147,161,773
48,64,177,179,160,178,806
29,42,103,86,65,81,406
33,59,148,153,141,146,680
47,67,181,182,156,165,798
44,68,192,199,170,169,842
44,53,154,173,141,138,703
29,41,127,136,95,94,522
31,45,115,110,102,103,506
39,51,155,161,146,151,703
42,50,152,153,141,148,686
49,58,174,196,169,154,800
13,26,54,64,45,40,242
14,21,49,50,40,43,217
32,45,118,124,115,119,553
40,60,150,170,152,153,725
47,62,174,188,160,160,791
38,55,157,148,140,137,675
33,50,135,152,127,115,612
36,58,158,163,141,147,703
41,57,149,160,143,129,679
37,58,161,153,135,122,666
11,23,54,63,49,44,244
42,46,138,137,110,128,601
39,52,135,134,127,132,619
20,25,54,59,56,67,281
43,50,141,157,145,147,683
2,2,10,5,0,8,27
49,76,182,185,161,174,827
12,18,39,40,32,46,187
29,48,132,142,119,130,600
36,51,132,139,119,127,604
35,52,133,130,112,103,565
37,59,158,161,132,124,671
37,59,158,161,132,124,671
22,31,87,89,75,67,371
37,58,147,149,134,138,663
33,51,127,128,120,132,591
41,57,156,147,128,134,663
28,49,113,128,113,121,552
34,43,116,121,109,116,539
20,29,76,83,58,53,319
48,60,171,174,157,167,777
41,54,145,152,131,135,658
19,25,49,50,42,54,239
19,26,70,72,60,58,305
21,26,68,71,72,79,337
26,31,86,97,83,80,403
56,76,201,198,169,168,868
47,62,176,186,164,158,793
42,60,174,184,147,151,758
37,52,141,144,124,117,615
13,37,67,70,63,37,287
41,56,158,163,155,146,719
44,62,159,180,162,166,773
26,40,91,96,96,94,443
33,48,105,100,100,105,491
43,70,169,190,160,165,797
22,25,77,78,72,72,346
23,35,88,79,79,72,376
21,33,77,89,88,102,410
4,4,2,1,3,5,19
39,60,157,166,137,150,709
33,39,111,105,94,74,456
31,39,98,115,105,110,498
30,43,106,118,108,109,514
1,3,2,10,8,2,26
6,8,8,12,12,13,59
33,49,134,132,114,136,598
0,2,3,4,3,1,13
48,64,179,185,172,170,818
39,59,172,176,163,165,774
12,19,39,49,38,32,189
2,2,2,7,5,6,24
4,5,7,9,11,4,40
0,1,1,5,6,1,14
25,36,92,88,80,93,414
44,52,149,157,143,135,680
17,32,80,65,66,78,338
15,24,58,57,59,61,274
28,37,106,97,88,76,432
40,55,188,194,156,155,788
41,46,148,145,128,114,622
50,74,199,205,171,173,872
19,27,70,87,76,69,348
22,25,74,76,62,68,327
21,31,70,70,53,66,311
8,23,50,50,33,45,209
25,38,85,82,71,73,374
14,22,51,49,31,42,209
32,38,106,110,94,86,466
3,5,4,7,3,2,24
17,23,67,77,61,56,301
2,2,2,3,3,7,19
22,28,70,85,85,83,373
22,36,79,89,80,94,400
21,39,90,91,77,84,402
22,29,63,75,74,65,328
28,41,100,105,93,103,470
40,51,141,148,122,126,628
2,4,2,1,3,0,12
11,27,52,63,49,47,249
2,7,15,18,15,7,64
34,50,142,136,120,122,604
47,63,175,187,157,162,791
38,55,150,145,133,136,657
45,68,179,180,167,155,794
24,36,77,74,75,80,366
48,69,190,202,164,162,835
47,65,195,199,180,173,859
43,60,173,196,167,172,811
48,72,197,194,152,162,825
14,64,118,104,70,54,424
11,22,54,54,49,57,247
48,73,181,196,169,185,852
39,56,147,147,140,135,664
