58,79,188,187,159,151,822
19,22,61,73,76,85,336
11,24,27,28,27,17,134
27,32,69,78,71,68,345
55,73,198,201,175,166,868
16,34,36,40,28,16,170
44,69,158,161,134,134,700
23,32,82,64,56,69,326
21,30,83,78,70,85,367
51,71,191,195,170,165,843
20,38,97,107,89,91,442
14,26,68,69,52,58,287
20,31,70,79,89,85,374
25,39,80,83,78,66,371
11,16,21,32,23,5,108
17,22,60,62,59,58,278
15,35,36,42,37,24,189
23,28,73,76,69,70,339
17,24,57,67,52,45,262
18,22,53,59,57,57,266
17,25,69,69,55,57,292
25,30,62,62,57,57,293
46,59,138,141,124,134,642
31,30,77,74,65,66,343
52,66,180,184,175,174,831
23,37,92,99,67,69,387
28,39,102,92,87,94,442
29,29,90,91,82,81,402
51,78,186,188,161,168,832
17,36,38,42,33,16,182
18,26,58,57,54,55,268
52,68,171,168,148,162,769
27,48,110,105,85,95,470
28,33,88,96,97,114,456
52,74,183,182,161,167,819
33,58,139,156,142,136,664
17,31,34,31,32,21,166
19,30,68,67,61,70,315
11,21,23,29,30,19,133
14,26,28,27,22,15,132
44,59,147,155,145,144,694
43,61,155,157,144,144,704
49,65,175,180,162,167,798
50,66,164,173,166,161,780
16,30,28,29,31,19,153
30,40,108,103,78,88,447
27,24,88,93,76,82,390
27,38,96,101,87,86,435
45,64,166,186,160,158,779
3,12,18,23,19,10,85
19,22,73,80,75,72,341
8,19,17,24,21,13,102
41,53,148,145,124,130,641
23,34,80,82,81,84,384
16,28,57,70,74,63,308
14,29,78,76,65,80,342
23,36,85,86,72,72,374
9,7,7,7,9,9,48
14,34,33,27,22,9,139
12,26,35,30,31,18,152
28,35,70,85,79,53,350
16,23,70,76,70,68,323
24,27,76,80,85,87,379
37,55,150,167,129,116,654
12,28,28,29,23,11,131
22,27,70,74,73,76,342
14,20,56,61,57,57,265
22,30,76,70,62,74,334
48,73,188,196,161,172,838
38,36,103,101,89,85,452
35,37,103,103,105,88,471
47,63,166,175,148,155,754
51,71,177,189,175,165,828
56,70,188,193,167,151,825
30,36,85,88,81,89,409
11,11,48,57,52,46,225
34,49,110,102,94,97,486
22,33,73,76,70,75,349
40,50,119,108,102,108,527
19,31,90,97,79,83,399
15,26,29,36,25,10,141
41,62,147,145,132,144,671
32,52,149,151,130,139,653
27,31,77,71,64,74,344
48,65,155,165,160,149,742
14,22,20,32,24,10,122
14,27,22,31,26,8,128
12,26,28,37,27,9,139
32,57,159,158,132,138,676
15,24,59,64,57,62,281
32,34,104,100,91,90,451
29,34,71,80,82,60,356
38,50,129,141,120,125,603
34,48,109,118,100,88,497
48,61,152,159,139,134,693
54,82,193,202,190,165,886
20,38,97,96,63,70,384
11,28,24,20,19,13,115
2,2,17,22,18,13,74
30,45,108,108,95,94,480
46,65,170,177,158,159,775
29,46,110,111,89,81,466
53,78,193,189,166,169,848
25,33,89,98,80,80,405
28,38,101,98,93,82,440
43,56,165,169,147,152,732
9,17,42,41,38,40,187
12,24,22,21,20,15,114
15,30,30,29,27,19,150
33,53,119,111,98,102,516
12,28,27,29,24,10,130
45,59,162,168,158,157,749
25,31,76,81,73,77,363
18,33,32,32,31,17,163
34,48,109,102,94,97,484
12,27,27,27,21,21,135
23,29,85,80,64,97,378
19,28,79,89,92,109,416
31,39,88,89,74,74,395
39,61,159,179,169,165,772
21,23,62,65,68,65,304
19,27,32,34,29,14,155
12,22,30,23,21,17,125
18,22,76,62,52,47,277
37,48,134,128,120,117,584
50,65,192,191,155,167,820
41,49,142,156,145,148,681
31,42,102,104,96,100,475
52,69,175,181,167,169,813
12,27,30,36,30,13,148
8,25,24,19,15,18,109
15,27,24,31,24,16,137
13,25,20,35,27,15,135
40,50,130,141,128,147,636
28,34,85,100,87,92,426
39,63,143,159,143,146,693
45,64,171,187,171,172,810
16,24,71,84,72,67,334
12,28,37,35,30,20,162
20,15,57,60,48,58,258
51,64,173,166,139,140,733
26,32,78,75,62,69,342
13,38,40,39,32,17,179
18,32,40,40,30,14,174
11,21,55,58,54,57,256
11,28,31,27,33,21,151
25,39,83,86,83,89,405
28,47,107,112,110,122,526
28,24,83,88,76,71,370
43,62,169,177,146,167,764
28,42,119,124,94,92,499
42,63,145,162,146,137,695
9,22,24,24,21,22,122
29,44,105,97,85,85,445
22,20,61,55,50,48,256
23,41,109,116,101,90,480
54,77,185,195,185,171,867
43,48,136,147,120,129,623
10,19,20,23,23,14,109
12,22,55,62,63,61,275
14,18,60,68,54,56,270
45,62,158,162,151,150,728
8,26,35,40,28,19,156
12,30,31,31,32,16,152
33,30,89,82,85,90,409
8,13,36,42,45,49,193
6,7,7,9,10,6,45
24,38,96,99,88,79,424
30,30,98,94,86,80,418
52,70,175,196,178,160,831
16,26,45,47,46,50,230
15,27,18,17,19,12,108
52,67,192,193,160,164,828
4,5,6,7,7,5,34
13,21,53,50,56,52,245
41,56,153,148,129,138,665
19,25,60,66,49,59,278
22,33,80,77,73,76,361
45,65,158,165,152,152,737
24,27,55,54,53,54,267
41,49,126,137,114,120,587
26,31,72,81,78,59,347
6,2,9,15,15,7,54
14,30,28,34,28,16,150
19,28,59,62,58,58,284
26,34,100,107,79,80,426
50,73,172,189,172,159,815
52,71,173,178,165,169,808
49,63,167,154,149,134,716
3,5,2,6,9,14,39
14,14,55,58,59,56,256
32,43,111,108,88,97,479
13,16,48,44,33,36,190
54,76,180,185,164,153,812
33,38,107,96,91,88,453
27,29,88,94,75,87,400
17,27,24,32,27,13,140
14,27,22,30,26,9,128
14,29,28,32,32,14,149
17,35,41,38,32,12,175
10,26,28,35,25,17,141
16,33,42,38,31,21,181
32,41,114,108,86,96,477
32,30,78,81,81,80,382
9,11,24,21,18,25,108
5,13,10,14,17,13,72
17,28,32,37,35,21,170
23,35,92,94,76,66,386
15,21,56,53,47,49,241
42,54,151,162,139,140,688
43,54,146,152,137,153,685
16,29,69,69,47,50,280
8,21,22,27,23,5,106
20,32,83,93,85,106,419
10,31,36,30,28,18,153
13,29,38,32,24,18,154
20,25,66,72,67,72,322
49,67,179,179,151,161,786
17,28,68,71,55,62,301
44,67,172,192,172,180,827
52,63,173,177,160,167,792
29,43,96,82,76,100,426
26,40,97,87,81,87,418
8,15,20,24,19,19,105
33,48,110,104,99,107,501
27,41,101,105,110,130,514
21,35,92,85,80,92,405
44,55,134,123,116,117,589
10,27,28,26,26,23,140
15,24,70,81,68,62,320
15,26,61,63,68,76,309
17,15,64,60,44,49,249
30,36,94,93,83,90,426
28,30,79,89,90,85,401
9,21,21,25,23,13,112
42,57,141,133,111,126,610
54,71,179,189,165,173,831
54,65,172,178,168,172,809
45,56,154,162,144,141,702
9,20,28,33,28,19,137
12,35,33,35,30,14,159
6,11,25,27,20,23,112
24,28,81,88,89,73,383
9,21,24,27,22,18,121
20,37,87,83,70,79,376
13,25,24,33,23,10,128
15,21,60,66,55,50,267
28,40,101,105,83,70,427
24,29,77,90,87,77,384
6,12,16,22,22,12,90
34,55,134,145,132,115,615
40,55,139,152,126,134,646
11,24,26,33,21,10,125
52,71,181,184,168,179,835
12,33,38,37,31,16,167
26,36,96,100,88,74,420
27,42,100,94,72,81,416
5,4,5,4,4,6,28
12,29,35,35,28,15,154
28,48,107,97,88,101,469
7,15,18,23,21,12,96
32,40,113,126,109,104,524
51,71,190,198,160,170,840
12,29,37,39,35,21,173
32,41,108,103,100,110,494
34,48,109,117,100,85,493
25,39,93,94,78,92,421
28,39,115,121,98,114,515
37,53,132,127,117,136,602
8,30,40,35,35,22,170
27,44,98,102,95,110,476
45,64,173,191,171,163,807
43,69,170,176,157,166,781
41,55,148,156,134,133,667
32,37,118,119,108,123,537
5,2,25,32,28,18,110
17,30,34,34,33,17,165
15,32,35,39,34,17,172
25,49,118,117,105,107,521
27,36,94,89,79,87,412
28,35,92,97,91,75,418
17,32,34,37,34,17,171
51,78,194,194,173,173,863
24,42,105,103,88,96,458
12,23,26,26,21,12,120
20,36,39,35,36,22,188
52,64,167,160,143,148,734
12,33,34,33,33,20,165
33,60,140,140,117,131,621
44,71,172,164,151,138,740
19,27,65,77,64,71,323
17,31,75,65,44,56,288
37,50,125,122,102,121,557
29,32,90,103,97,105,456
19,23,54,54,56,52,258
46,53,141,142,122,134,638
10,21,25,29,28,26,139
29,41,107,109,83,87,456
10,14,47,56,47,45,219
35,47,122,119,95,92,510
11,23,30,32,27,12,135
11,22,53,62,53,50,251
43,52,140,151,138,131,655
36,55,157,151,134,147,680
42,57,143,133,110,126,611
10,24,29,25,22,11,121
11,26,26,31,25,10,129
31,43,117,132,108,86,517
10,7,11,12,8,9,57
13,24,54,49,45,60,245
22,35,85,76,81,79,378
41,52,124,130,114,124,585
25,29,80,87,89,86,396
47,61,160,161,140,152,721
36,45,111,103,85,92,472
14,32,36,30,28,20,160
47,55,148,150,130,139,669
46,69,165,174,157,155,766
13,26,22,35,26,16,138
24,27,85,85,72,67,360
52,71,177,181,163,175,819
37,52,137,129,113,114,582
31,35,92,95,84,92,429
50,64,169,168,151,150,752
53,70,182,198,173,180,856
51,68,174,176,157,147,773
26,24,71,77,83,76,357
15,31,32,35,32,19,164
30,46,132,137,125,120,590
32,44,111,111,103,113,514
43,61,170,168,142,153,737
7,4,9,6,6,11,43
23,38,102,107,85,96,451
25,28,76,77,64,71,341
45,59,142,144,131,144,665
10,29,37,33,34,20,163
7,24,22,31,31,15,130
10,29,29,25,26,14,133
13,24,22,22,17,19,117
38,52,143,154,138,145,670
20,34,94,96,88,89,421
40,57,152,150,128,131,658
21,36,96,106,91,96,446
24,31,71,78,84,83,371
24,31,84,91,71,67,368
15,24,64,67,63,58,291
50,64,169,168,151,150,752
53,71,179,197,170,178,848
5,6,7,2,4,7,31
44,56,157,172,152,151,732
13,28,33,31,23,18,146
39,53,160,166,137,142,697
28,47,119,132,107,109,542
24,32,83,87,73,87,386
13,29,25,35,31,22,155
8,8,6,8,5,3,38
14,20,58,62,61,64,279
5,13,18,27,24,11,98
17,22,61,73,63,64,300
32,42,83,86,78,68,389
14,20,22,23,19,17,115
21,25,76,71,65,56,314
21,36,77,87,85,73,379
32,36,95,89,87,115,454
25,34,88,101,82,99,429
21,30,75,75,65,55,321
25,29,91,94,79,86,404
22,27,70,78,60,55,312
26,39,101,101,83,88,438
5,4,3,2,3,7,24
3,12,18,22,15,6,76
6,6,7,7,4,1,31
29,39,100,95,78,85,426
26,32,80,88,81,62,369
50,68,171,177,151,167,784
19,23,59,75,71,66,313
12,16,13,17,17,13,88
10,19,24,35,35,19,142
40,56,147,151,142,162,698
37,52,153,164,145,158,709
18,32,53,59,48,36,246
37,54,140,141,124,121,617
39,57,150,156,139,127,668
44,57,162,172,150,175,760
11,20,26,19,21,22,119
41,56,158,165,138,144,702
40,51,139,161,139,140,670
2,3,4,8,7,3,27
50,58,149,149,135,138,679
7,19,18,15,20,15,94
41,59,144,142,122,140,648
35,49,128,140,125,141,618
24,31,81,73,73,84,366
29,29,89,90,81,81,399
27,45,107,113,111,124,527
11,18,21,20,20,15,105
39,55,143,148,144,159,688
16,10,42,42,32,41,183
46,56,156,153,131,139,681
8,17,19,24,20,15,103
46,60,167,170,138,138,719
36,54,138,145,131,129,633
17,12,48,55,45,53,230
21,37,96,103,93,94,444
38,60,146,150,124,125,643
24,28,69,73,70,71,335
41,48,148,158,130,136,661
14,25,25,35,22,10,131
43,54,147,167,138,124,673
40,60,148,161,144,175,728
17,34,82,81,77,78,369
37,52,129,139,114,113,584
36,60,143,152,132,123,646
35,46,105,109,102,103,500
3,2,5,2,1,0,13
9,21,27,30,23,8,118
13,26,19,28,21,9,116
14,25,53,47,43,49,231
1,3,4,7,6,6,27
23,19,55,54,50,42,243
29,40,111,123,121,111,535
15,27,28,26,26,19,141
5,12,9,8,9,6,49
6,7,17,16,14,20,80
4,1,5,7,5,7,29
13,27,28,24,27,21,140
45,71,177,178,155,166,792
19,35,82,83,82,75,376
28,40,98,100,95,90,451
9,23,29,38,41,25,165
38,63,163,175,160,150,749
12,25,26,29,24,18,134
12,26,28,25,25,9,125
16,21,53,55,57,57,259
46,68,169,178,145,160,766
2,4,3,5,5,4,23
40,47,133,145,131,125,621
4,9,11,17,14,6,61
45,61,168,170,153,164,761
25,36,95,93,84,91,424
4,7,6,8,10,8,43
36,55,139,145,115,118,608
9,13,11,18,15,8,74
22,26,72,79,70,66,335
48,67,170,179,156,157,777
10,21,28,35,29,9,132
23,26,80,71,68,67,335
33,39,102,99,85,88,446
36,53,165,180,158,160,752
1,0,1,0,3,4,9
11,24,25,28,24,18,130
12,30,35,36,34,30,177
28,40,101,103,75,87,434
15,29,27,24,28,14,137
14,21,44,44,47,51,221
39,55,143,146,128,135,646
47,61,161,163,146,149,727
5,3,5,1,6,9,29
20,37,34,40,31,20,182
40,58,139,139,123,140,639
37,54,156,163,154,141,705
49,71,178,173,155,164,790
12,26,27,34,27,13,139
7,12,12,13,13,4,61
10,16,21,29,29,19,124
49,65,168,177,152,161,772
9,17,16,23,21,16,102
4,8,6,5,5,3,31
9,7,7,5,8,6,42
35,49,120,123,116,122,565
44,64,167,171,152,165,763
35,50,132,131,107,104,559
47,72,186,190,169,169,833
34,52,143,141,119,120,609
36,47,142,158,145,147,675
39,57,152,156,137,126,667
41,58,140,144,132,137,652
32,41,107,109,112,123,524
25,33,77,74,78,69,356
12,29,33,31,24,17,146
51,68,168,171,135,136,729
12,15,47,60,50,49,233
39,57,142,141,127,142,648
38,63,163,175,159,149,747
8,12,15,14,16,11,76
19,27,75,66,59,66,312
10,16,15,19,23,11,94
43,64,158,157,141,159,722
12,25,36,36,29,25,163
4,5,5,4,3,1,22
38,63,155,155,134,143,688
8,23,26,24,21,18,120
49,63,176,176,159,160,783
1,1,2,3,1,6,14
29,46,114,106,99,108,502
30,41,99,107,103,96,476
47,58,145,151,146,148,695
17,33,36,40,29,16,171
23,31,94,108,86,75,417
39,55,135,149,128,108,614
48,64,176,180,157,169,794
28,33,97,99,83,76,416
41,53,136,151,133,134,648
3,10,10,11,11,3,48
40,53,153,159,132,130,667
39,63,151,163,131,132,679
41,65,158,165,149,158,736
1,0,3,2,2,1,9
49,62,171,180,154,163,779
42,55,178,195,165,176,811
42,60,153,162,150,149,716
43,60,165,173,157,150,748
3,2,3,4,6,10,28
2,2,13,12,5,7,41
10,22,29,27,24,18,130
9,16,46,41,37,38,187
30,48,116,135,127,123,579
49,70,173,164,137,157,750
4,3,4,3,4,3,21
40,61,159,159,132,147,698
10,18,19,28,23,12,110
41,60,165,169,151,151,737
27,44,110,104,89,92,466
40,58,152,150,125,141,666
3,12,16,16,15,10,72
42,58,154,170,144,156,724
5,12,20,23,19,8,87
13,29,31,32,25,19,149
35,52,147,158,137,133,662
25,32,93,92,76,82,400
40,48,137,144,133,138,640
28,29,88,79,69,84,377
45,65,174,180,163,163,790
10,10,10,15,19,10,74
34,49,127,124,103,104,541
26,45,76,79,68,68,362
26,27,71,72,66,66,328
35,53,141,138,120,120,607
8,25,26,25,26,19,129
39,52,145,152,129,144,661
48,63,170,186,163,176,806
10,19,14,19,19,13,94
43,70,173,166,153,157,762
27,42,106,100,88,83,446
29,44,128,135,112,124,572
10,21,19,16,18,11,95
41,60,158,162,141,153,715
11,26,22,22,24,19,124
27,36,98,98,89,92,440
13,24,25,23,19,20,124
2,6,6,15,14,1,44
40,65,164,171,152,153,745
49,59,156,167,145,137,713
1,2,3,4,2,2,14
27,27,78,81,66,63,342
21,31,73,83,74,78,360
27,30,79,84,72,68,360
14,29,34,35,24,16,152
14,45,50,50,51,31,241
17,37,33,34,31,24,176
30,136,137,169,161,48,681
31,39,75,68,64,65,342
30,176,188,206,189,45,834
1,4,3,2,1,1,12
4,2,6,4,2,6,24
32,45,115,117,96,107,512
27,147,163,167,152,38,694
31,154,159,149,143,44,680
32,44,102,100,87,82,447
30,38,99,109,91,97,464
22,29,80,74,61,67,333
13,27,29,30,32,18,149
14,34,45,46,42,29,210
7,5,9,8,5,10,44
14,39,40,47,44,25,209
0,0,3,3,1,4,11
15,33,44,47,34,17,190
15,32,26,30,27,23,153
28,155,168,173,163,47,734
20,22,70,81,76,72,341
21,150,159,153,130,35,648
8,21,29,34,31,11,134
16,101,122,117,95,37,488
1,1,3,4,2,6,17
15,44,46,44,36,27,212
24,29,89,88,70,59,359
26,40,99,108,84,86,443
4,11,15,9,9,6,54
7,8,10,13,12,7,57
27,33,84,87,78,86,395
27,38,96,94,80,77,412
25,38,96,101,93,102,455
14,36,41,41,32,22,186
12,29,27,33,28,14,143
17,35,57,54,57,63,283
10,17,21,25,22,11,106
34,145,157,166,159,47,708
8,7,8,7,6,9,45
27,29,67,62,52,52,289
3,1,5,1,0,4,14
30,143,157,168,159,44,701
2,12,14,14,15,2,59
25,135,149,155,134,44,642
34,36,88,98,94,96,446
18,47,49,50,47,33,244
11,19,16,21,17,10,94
22,133,144,147,132,39,617
26,158,169,170,158,53,734
17,15,61,74,70,62,299
1,1,0,1,1,2,6
26,41,105,127,113,110,522
24,31,85,73,77,71,361
11,42,52,53,44,28,230
22,30,89,88,84,92,405
21,25,63,67,67,67,310
24,37,102,105,86,81,435
29,40,99,108,97,109,482
30,157,172,176,156,39,730
14,32,36,29,24,18,153
24,38,97,103,83,82,427
19,38,36,38,30,18,179
27,39,83,89,79,80,397
23,157,166,150,140,43,679
19,31,96,102,90,95,433
16,47,53,50,48,38,252
12,20,69,76,61,73,311
12,11,33,31,21,43,151
16,42,44,44,41,29,216
12,16,39,41,45,50,203
5,4,9,5,5,8,36
19,25,71,66,51,64,296
18,118,125,118,117,35,531
18,32,23,31,31,16,151
16,37,45,40,38,25,201
6,4,7,3,3,6,29
35,172,179,180,154,39,759
5,5,0,1,3,11,25
2,0,2,2,3,5,14
11,26,29,26,23,8,123
14,47,48,49,48,26,232
31,157,158,160,146,42,694
7,4,11,12,11,7,52
11,24,23,30,28,14,130
22,129,143,144,134,41,613
25,32,94,99,83,88,421
16,32,24,32,33,21,158
19,33,85,95,70,68,370
16,47,45,43,50,21,222
24,151,167,183,172,46,743
29,49,104,121,125,113,541
4,4,5,3,3,0,19
4,0,4,5,4,5,22
8,21,26,31,26,16,128
23,45,102,89,64,66,389
28,40,78,81,69,84,380
29,42,112,115,110,121,529
6,9,6,6,5,5,37
18,41,38,44,39,31,211
24,31,80,87,81,87,390
18,26,39,49,50,39,221
20,126,127,140,135,34,582
8,61,66,58,63,17,273
30,144,162,148,131,37,652
1,1,6,6,1,9,24
4,4,4,5,4,2,23
30,150,152,152,149,38,671
18,30,76,87,75,77,363
6,5,11,7,4,4,37
28,39,99,106,105,111,488
33,172,171,186,174,49,785
12,34,77,86,79,88,376
3,5,4,5,3,6,26
1,2,1,1,2,6,13
1,1,6,4,2,4,18
23,130,128,133,136,39,589
13,15,41,34,26,18,147
11,28,26,29,26,18,138
2,1,2,3,2,0,10
24,138,148,149,133,34,626
13,26,28,37,31,13,148
12,30,31,35,32,22,162
33,135,146,166,159,40,679
4,3,3,4,5,5,24
30,37,101,107,83,94,452
1,0,5,7,2,9,24
8,14,15,20,17,16,90
12,24,30,28,26,18,138
22,29,64,63,63,55,296
11,18,42,36,32,31,170
8,11,18,19,17,24,97
30,103,140,135,110,83,601
4,4,7,8,5,3,31
2,4,3,4,4,2,19
31,145,159,173,155,40,703
32,39,110,115,107,128,531
7,8,10,13,12,7,57
28,38,95,97,91,107,456
24,145,152,152,135,46,654
27,33,86,95,79,94,414
2,3,4,4,4,2,19
30,42,91,89,83,87,422
16,44,44,41,37,25,207
26,134,139,139,122,37,597
9,49,56,46,48,20,228
18,128,126,143,130,29,574
16,38,43,40,33,21,191
14,45,48,47,44,32,230
24,136,147,159,148,36,650
8,22,25,29,25,18,127
28,151,165,176,161,39,720
21,53,59,47,41,23,244
18,28,57,52,55,54,264
12,32,63,61,61,60,289
8,20,27,27,28,17,127
31,159,159,157,143,35,684
4,5,8,9,8,6,40
10,15,41,48,46,47,207
29,39,102,112,99,103,484
24,30,80,79,74,82,369
44,63,146,150,135,145,683
18,14,56,56,42,46,232
41,65,165,169,153,150,743
14,10,6,6,8,10,54
9,14,26,27,25,27,128
7,10,31,42,37,30,157
24,39,97,103,97,99,459
29,30,89,91,87,95,421
25,32,84,84,65,67,357
26,45,104,97,89,93,454
45,57,150,166,140,126,684
23,31,84,104,94,97,433
27,53,109,114,98,104,505
30,35,96,105,100,96,462
20,33,83,86,75,90,387
9,18,37,39,29,31,163
51,61,162,170,148,146,738
37,42,100,102,100,106,487
41,110,182,159,135,114,741
4,5,6,8,7,4,34
21,27,71,79,70,72,340
26,38,80,84,77,78,383
29,44,114,122,100,100,509
20,20,65,67,57,70,299
20,31,85,95,78,75,384
45,59,160,177,150,162,753
35,53,137,155,124,123,627
42,63,149,149,128,135,666
28,42,114,123,109,111,527
48,61,164,170,136,143,722
50,56,164,164,136,144,714
31,52,128,132,124,134,601
48,61,156,155,133,132,685
39,185,189,174,169,51,807
1,2,1,2,1,0,7
32,49,119,119,95,109,523
19,31,67,84,92,91,384
3,6,8,5,5,1,28
40,163,192,175,156,63,789
37,49,148,148,121,142,645
34,47,132,135,120,120,588
16,15,59,60,45,45,240
45,61,166,176,152,162,762
39,54,141,136,116,142,628
38,43,132,138,119,128,598
13,11,22,22,17,16,101
43,52,146,139,114,121,615
28,32,96,92,71,76,395
26,40,105,102,81,83,437
5,9,14,14,16,12,70
27,36,89,85,72,77,386
38,46,129,139,116,107,575
45,55,155,157,127,134,673
39,55,136,147,116,126,619
13,10,27,34,32,35,151
44,51,142,157,146,141,681
7,4,5,3,2,4,25
45,61,156,165,146,159,732
32,42,101,119,99,105,498
33,41,113,121,110,114,532
40,58,137,139,113,114,601
50,60,163,171,150,164,758
27,42,103,115,93,100,480
17,29,71,64,53,65,299
10,14,33,37,38,35,167
1,1,3,4,3,5,17
43,58,162,172,145,157,737
1,1,1,4,3,2,12
42,57,144,146,132,118,639
27,28,81,90,87,80,393
31,46,100,108,96,92,473
39,59,126,136,114,125,599
24,22,70,75,69,71,331
33,42,125,135,112,137,584
34,45,120,120,101,116,536
7,20,43,49,45,45,209
25,38,96,107,97,78,441
0,1,1,2,2,0,6
49,62,162,150,126,120,669
47,62,168,168,149,150,744
45,58,156,161,140,147,707
36,47,127,151,132,136,629
22,31,88,99,94,75,409
33,48,136,136,109,124,586
14,16,52,54,45,53,234
37,60,141,145,116,123,622
40,56,136,148,127,137,644
8,7,13,12,10,10,60
26,166,170,168,162,39,731
18,24,57,60,50,51,260
40,55,141,139,115,135,625
53,70,177,176,148,167,791
3,4,2,4,4,3,20
11,24,57,57,63,72,284
33,42,100,100,93,87,455
7,6,3,2,2,4,24
7,6,3,4,7,11,38
31,40,115,131,112,112,541
46,53,150,148,124,134,655
47,58,154,168,157,144,728
47,52,143,143,119,137,641
29,49,103,111,100,94,486
35,48,117,137,125,146,608
31,47,101,108,95,91,473
24,29,82,84,72,77,368
41,46,132,142,120,123,604
26,35,96,101,96,107,461
6,7,3,9,8,8,41
35,50,144,143,126,131,629
48,60,163,159,132,135,697
49,62,162,176,151,139,739
30,39,92,116,108,100,485
32,44,115,124,105,110,530
17,23,59,53,43,53,248
10,16,34,45,40,38,183
24,38,93,101,85,100,441
22,29,89,92,71,70,373
44,54,138,141,118,125,620
36,46,114,119,110,110,535
48,62,171,179,152,159,771
29,41,102,100,74,86,432
49,63,162,159,132,144,709
32,54,135,128,114,101,564
3,3,3,4,3,10,26
29,53,113,124,106,119,544
54,67,166,169,150,155,761
30,151,166,169,148,70,734
37,50,147,150,130,147,661
33,48,125,125,116,122,569
3,7,6,4,5,7,32
3,1,3,2,2,5,16
39,51,133,130,122,130,605
43,57,130,126,119,123,598
14,27,54,56,56,55,262
26,39,97,92,79,88,421
49,70,168,169,153,157,766
28,40,102,106,83,98,457
46,64,160,174,155,163,762
8,6,18,31,28,29,120
31,161,172,180,170,54,768
33,50,130,134,107,129,583
43,47,123,128,117,125,583
8,19,18,24,25,15,109
3,5,7,3,2,1,21
11,33,34,38,39,21,176
10,25,26,32,33,17,143
7,16,17,12,10,10,72
0,43,67,74,51,0,235
0,0,0,2,2,0,4
0,44,69,72,48,0,233
0,41,65,69,49,0,224
0,48,76,78,52,0,254
0,40,62,64,43,0,209
0,15,22,17,11,0,65
0,20,36,42,30,0,128
0,44,68,64,43,0,219
0,33,46,46,35,0,160
0,36,60,61,39,0,196
0,24,34,40,27,0,125
0,10,15,15,9,0,49
0,8,13,13,8,0,42
0,42,66,68,47,0,223
0,2,3,4,3,0,12
0,39,60,68,47,0,214
0,1,4,5,3,0,13
0,39,64,67,43,0,213
0,44,64,64,46,0,218
0,45,65,60,38,0,208
0,0,3,2,0,0,5
0,32,48,55,35,0,170
0,45,65,66,43,0,219
0,45,65,62,46,0,218
0,4,5,4,3,0,16
0,42,58,58,41,0,199
0,29,41,40,25,0,135
0,44,69,65,45,0,223
0,2,4,8,7,0,21
0,46,69,64,40,0,219
0,42,61,61,39,0,203
0,1,1,0,0,0,2
0,29,49,57,35,0,170
0,27,35,38,25,0,125
0,33,49,60,38,0,180
0,37,56,62,42,0,197
0,45,65,63,43,0,216
0,36,55,62,42,0,195
0,32,44,43,32,0,151
0,40,56,63,44,0,203
0,41,58,64,41,0,204
0,39,59,57,37,0,192
0,8,10,15,12,0,45
0,49,70,72,48,0,239
0,49,67,66,43,0,225
0,48,64,75,50,0,237
0,33,51,61,41,0,186
0,42,65,65,43,0,215
0,0,1,0,0,0,1
0,42,61,67,43,0,213
0,48,64,75,50,0,237
0,0,1,0,0,0,1
0,37,59,65,40,0,201
0,23,29,31,18,0,101
0,12,16,16,11,0,55
0,45,68,68,40,0,221
0,40,57,61,41,0,199
0,17,28,25,16,0,86
0,52,70,75,53,0,250
0,8,9,10,7,0,34
0,32,47,44,30,0,153
0,38,54,77,49,0,218
0,45,64,68,40,0,217
0,7,12,14,10,0,43
0,0,0,1,1,0,2
0,18,30,25,14,0,87
0,22,36,41,27,0,126
0,35,55,69,46,0,205
0,8,12,17,14,0,51
0,2,3,3,3,0,11
0,32,50,52,34,0,168
0,13,21,16,9,0,59
0,35,52,59,41,0,187
0,1,3,6,2,0,12
18,40,39,42,40,20,199
54,71,185,178,145,161,794
28,38,84,82,83,83,398
15,31,34,37,30,22,169
39,55,141,148,133,124,640
42,58,164,170,149,160,743
50,75,183,192,156,168,824
49,74,181,179,148,160,791
48,67,183,180,159,171,808
29,47,112,115,98,116,517
11,33,34,37,34,21,170
56,74,194,192,167,187,870
11,22,29,31,26,12,131
41,56,140,152,137,147,673
48,64,163,161,147,149,732
56,74,194,192,167,187,870
55,71,190,186,152,179,833
47,68,185,185,149,165,799
54,66,163,163,149,162,757
14,27,34,30,21,9,135
19,39,42,40,26,16,182
16,34,36,44,40,20,190
49,76,176,178,146,156,781
13,26,25,31,33,13,141
50,71,170,175,160,166,792
46,60,163,179,153,152,753
58,78,197,206,183,186,908
52,70,184,190,178,178,852
17,44,49,50,46,30,236
43,57,153,162,134,129,678
54,78,202,208,176,180,898
31,49,108,113,93,93,487
50,74,177,184,159,184,828
13,40,35,37,33,12,170
16,40,40,40,41,24,201
34,61,133,133,115,115,591
41,62,153,159,141,146,702
43,66,175,181,148,149,762
41,60,157,159,130,143,690
28,37,81,97,95,93,431
14,26,26,35,30,15,146
24,37,94,98,89,103,445
46,63,161,169,145,148,732
14,36,37,46,42,17,192
41,57,160,173,145,146,722
42,61,151,150,133,141,678
13,29,30,37,33,14,156
46,63,161,169,144,147,730
47,68,185,184,162,163,809
51,71,170,172,148,169,781
52,79,188,195,173,181,868
51,75,173,177,159,180,815
42,67,159,168,139,153,728
14,38,33,39,34,22,180
45,64,167,176,159,156,767
45,66,173,169,153,169,775
51,72,201,202,175,179,880
26,31,75,73,63,69,337
16,38,39,43,36,18,190
49,70,180,182,165,175,821
50,62,178,185,167,188,830
12,31,37,41,33,20,174
51,70,193,199,168,182,863
45,64,165,169,148,148,739
56,65,177,177,156,143,774
49,69,191,190,169,172,840
41,58,145,148,129,146,667
10,7,40,49,37,42,185
49,66,194,196,175,166,846
48,73,192,196,163,166,838
59,84,191,186,158,179,857
52,71,189,196,175,174,857
47,72,176,171,158,162,786
50,73,181,188,173,180,845
45,66,153,147,129,162,702
39,63,166,162,150,148,728
29,44,113,102,95,99,482
55,75,186,193,166,185,860
29,43,106,90,80,103,451
43,66,157,153,139,139,697
43,57,162,163,138,142,705
51,78,190,185,169,182,855
49,80,181,183,157,155,805
17,37,38,44,39,20,195
37,61,146,152,136,159,691
55,76,189,187,172,171,850
49,66,173,177,152,171,788
20,33,41,44,36,21,195
13,14,50,60,48,50,235
28,38,93,100,78,66,403
46,61,160,173,160,153,753
19,34,69,77,59,47,305
41,54,153,153,136,146,683
50,61,165,170,151,132,729
42,69,153,162,149,162,737
39,53,135,141,121,132,621
19,36,66,55,44,44,264
53,73,187,176,138,155,782
22,37,78,91,79,75,382
34,47,122,121,113,112,549
46,54,153,152,137,150,692
45,65,170,174,145,164,763
57,72,189,185,149,176,828
24,33,71,69,67,71,335
48,71,182,182,159,169,811
52,75,190,191,171,183,862
40,63,164,179,157,160,763
41,70,159,172,147,139,728
41,54,158,166,140,142,701
39,50,133,148,133,140,643
18,36,42,44,37,22,199
50,77,191,191,172,172,853
46,55,150,163,137,123,674
43,69,166,169,149,156,752
14,30,32,33,26,17,152
25,33,85,89,83,88,403
51,73,192,196,168,178,858
51,69,189,197,174,164,844
53,80,191,186,153,165,828
14,32,35,40,33,19,173
41,53,155,153,130,126,658
48,70,170,186,166,168,808
12,26,25,33,34,17,147
12,31,30,30,29,16,148
47,67,164,184,153,164,779
55,78,192,201,182,182,890
15,41,38,46,44,18,202
56,76,190,198,165,160,845
49,66,168,169,138,148,738
50,68,188,200,187,175,868
48,71,186,186,166,169,826
54,71,195,193,164,179,856
40,56,145,157,126,110,634
0,41,64,65,48,6,224
48,74,194,196,171,175,858
53,76,202,210,177,164,882
29,65,142,132,114,117,599
44,65,172,180,164,185,810
21,26,89,96,76,79,387
1,3,4,2,1,2,13
4,3,7,5,3,3,25
49,73,203,215,174,161,875
55,72,193,199,176,177,872
49,72,200,203,172,175,871
49,80,189,190,162,177,847
22,29,77,85,82,68,363
50,79,176,193,179,184,861
58,70,189,198,183,193,891
53,74,187,196,165,171,846
51,74,197,206,180,190,898
54,76,189,202,177,180,878
55,73,190,188,174,181,861
49,69,188,199,170,162,837
57,84,191,195,180,181,888
53,75,199,187,160,171,845
54,75,197,186,160,171,843
49,69,188,199,170,162,837
54,74,188,187,167,176,846
54,75,194,199,176,190,888
0,0,1,1,0,0,2
49,69,179,200,175,179,851
50,74,188,199,180,188,879
49,64,185,197,169,171,835
44,72,182,184,165,173,820
52,80,192,193,170,173,860
51,71,187,188,166,178,841
49,67,184,190,174,178,842
50,69,189,179,159,164,810
48,69,192,206,181,185,881
50,82,182,186,170,180,850
58,65,183,189,166,174,835
59,74,183,189,167,177,849
48,71,193,194,168,176,850
47,73,189,200,177,186,872
51,71,185,191,162,189,849
49,69,187,196,169,166,836
29,129,131,130,125,39,583
12,28,21,32,30,22,145
31,150,164,171,148,40,704
15,41,43,49,45,31,224
13,30,33,37,34,20,167
33,41,112,122,94,93,495
16,22,58,60,59,58,273
17,46,46,45,40,27,221
27,31,88,90,91,100,427
25,141,143,145,124,33,611
21,22,79,98,84,79,383
37,45,126,132,110,102,552
39,57,147,149,132,133,657
56,72,182,185,164,166,825
29,36,104,110,102,90,471
44,61,165,167,142,155,734
25,38,99,99,80,87,428
46,66,161,167,159,160,759
48,62,170,180,163,161,784
53,70,192,192,174,181,862
47,65,174,172,151,155,764
411,1061,2160,2162,1830,2157,9781
42,49,155,143,120,137,646
47,57,162,166,148,155,735
23,37,83,86,72,79,380
20,24,68,77,69,78,336
48,69,193,192,169,171,842
45,63,190,191,158,154,801
24,26,71,83,79,61,344
29,45,117,112,98,110,511
24,42,108,103,76,92,445
53,59,183,188,164,163,810
14,26,74,82,61,84,341
42,50,130,138,121,117,598
58,71,199,200,177,185,890
45,63,170,175,149,165,767
55,71,186,181,158,158,809
13,26,70,85,81,77,352
332,785,1569,1564,1282,1540,7072
25,34,100,112,96,106,473
52,69,187,189,178,184,859
41,57,156,158,141,146,699
27,43,111,115,93,106,495
19,29,72,80,75,75,350
27,48,110,106,86,95,472
32,35,91,90,72,89,409
38,56,143,149,135,141,662
32,50,117,117,96,102,514
57,69,194,184,154,172,830
15,20,76,69,59,62,301
19,27,88,97,74,88,393
44,63,162,163,137,149,718
33,39,118,119,113,117,539
34,47,122,132,123,132,590
47,66,170,173,164,150,770
51,77,202,190,163,176,859
22,31,70,71,66,71,331
31,45,117,126,105,107,531
27,40,103,111,90,94,465
41,63,161,160,144,161,730
48,59,172,178,162,176,795
23,25,78,76,67,80,349
48,64,179,177,153,161,782
54,66,176,189,171,165,821
56,68,198,195,170,184,871
49,67,175,180,163,166,800
54,80,199,196,177,164,870
37,45,113,125,115,113,548
36,58,149,151,135,141,670
50,61,156,156,132,122,677
32,45,115,111,98,107,508
26,29,93,92,66,77,383
39,57,143,153,130,123,645
36,42,106,117,113,102,516
23,28,78,84,76,70,359
30,38,123,123,107,112,533
54,68,187,177,158,161,805
25,31,80,78,82,76,372
42,66,178,183,158,175,802
19,30,62,64,54,56,285
50,69,182,172,142,162,777
39,57,142,152,131,123,644
28,38,97,100,81,87,431
29,40,108,113,96,99,485
34,49,133,137,132,127,612
45,61,157,152,145,142,702
38,66,163,165,137,141,710
45,55,147,156,136,134,673
42,53,153,151,122,140,661
36,46,111,115,101,90,499
25,26,90,90,78,69,378
37,59,152,150,128,142,668
43,58,151,153,145,151,701
53,67,173,170,139,153,755
43,65,159,153,137,151,708
42,62,163,162,135,147,711
30,41,123,114,103,118,529
48,69,163,161,147,150,738
44,67,165,180,160,159,775
51,70,184,192,178,181,856
22,35,92,104,97,103,453
51,66,186,198,172,175,848
47,66,181,181,152,160,787
40,55,139,136,115,126,611
43,58,148,152,132,149,682
27,35,100,92,70,79,403
19,28,85,91,84,104,411
24,40,101,108,90,100,463
38,57,134,142,130,145,646
39,61,147,161,143,141,692
52,75,191,185,166,167,836
5,5,2,2,3,9,26
35,41,121,145,132,142,616
40,51,137,133,125,128,614
33,56,141,150,140,147,667
28,45,121,136,130,134,594
31,42,118,116,105,109,521
42,54,153,155,136,135,675
27,48,116,122,97,107,517
27,46,120,124,109,108,534
28,45,104,99,92,118,486
6,3,7,7,5,6,34
41,48,133,131,125,133,611
37,58,149,164,144,155,707
48,68,169,174,159,153,771
32,46,130,124,103,116,551
29,35,101,113,100,96,474
33,43,116,117,113,94,516
28,41,109,125,96,93,492
40,61,149,151,131,129,661
18,23,79,78,65,79,342
26,29,92,92,79,77,395
17,28,72,70,58,67,312
25,26,66,69,65,58,309
22,27,82,95,81,79,386
36,49,117,116,96,97,511
53,74,176,183,160,166,812
48,67,190,180,155,172,812
17,23,57,69,54,44,264
51,78,193,193,175,172,862
44,55,144,149,124,133,649
50,64,171,168,148,175,776
59,78,200,188,174,185,884
36,54,129,135,124,121,599
39,56,143,151,136,153,678
64,68,198,181,167,190,868
870,2364,4701,4794,3841,4680,21250
31,46,121,132,114,101,545
56,73,192,186,174,187,868
51,76,186,194,173,174,854
49,63,182,180,167,158,799
50,69,194,210,184,169,876
54,76,193,202,192,187,904
5,6,10,10,7,8,46
43,60,143,153,129,148,676
52,68,193,189,172,185,859
51,65,174,175,150,161,776
36,44,124,126,112,114,556
40,56,138,122,105,127,588
51,70,183,184,156,158,802
39,53,146,156,126,125,645
50,71,177,186,160,180,824
48,70,183,181,161,180,823
53,69,168,177,160,170,797
31,58,139,138,117,128,611
0,42,69,72,43,0,226
36,42,134,137,122,128,599
41,66,157,160,139,150,713
35,54,129,110,99,116,543
54,71,171,182,167,160,805
42,58,143,161,147,145,696
51,76,189,190,171,179,856
58,81,200,199,192,179,909
39,54,145,154,125,137,654
49,73,181,173,147,171,794
40,51,136,145,111,123,606
44,69,172,169,159,186,799
53,73,182,188,167,182,845
132,277,546,572,421,511,2459
26,34,114,128,120,130,552
50,64,181,187,166,154,802
46,59,155,148,129,146,683
46,66,165,174,160,155,766
37,59,145,142,125,138,646
38,44,120,122,109,122,555
43,66,176,169,158,187,799
52,71,182,197,176,183,861
24,22,55,49,51,53,254
49,75,196,191,166,172,849
46,65,178,182,159,177,807
52,68,189,194,159,168,830
56,77,190,180,157,175,835
33,51,137,129,108,123,581
45,64,171,184,162,169,795
48,65,167,172,160,166,778
51,69,170,175,160,155,780
55,69,189,192,174,178,857
52,76,190,193,166,176,853
0,47,71,72,42,1,233
52,67,173,178,152,163,785
50,78,187,191,186,192,884
42,59,158,179,154,149,741
43,54,143,143,120,122,625
13,42,94,97,73,43,362
45,54,173,187,173,158,790
56,74,192,183,170,181,856
37,55,133,133,116,119,593
33,32,122,131,104,96,518
45,57,156,156,142,147,703
24,47,116,127,105,127,546
34,39,112,117,105,106,513
36,53,147,149,117,133,635
53,67,182,189,169,174,834
43,53,143,145,121,117,622
50,63,159,161,145,153,731
49,68,185,190,155,154,801
43,61,160,150,134,132,680
52,68,184,188,170,177,839
48,63,181,181,152,163,788
43,52,147,145,124,124,635
40,50,121,143,123,105,582
47,57,159,176,147,154,740
0,46,66,69,47,0,228
50,72,185,200,167,178,852
14,44,52,52,51,29,242
41,48,123,124,108,125,569
54,79,215,214,183,176,921
23,50,52,57,56,38,276
0,45,71,83,53,0,252
23,47,55,56,53,38,272
48,66,155,171,163,149,752
1,48,68,74,57,14,262
0,52,71,74,51,0,248
23,44,49,58,54,30,258
29,48,114,124,124,114,553
39,51,133,123,108,112,566
39,51,149,157,132,140,668
51,72,182,183,147,163,798
44,60,164,177,145,141,731
0,52,71,76,49,0,248
23,51,51,57,56,40,278
52,64,160,171,153,147,747
28,54,120,117,101,97,517
0,47,69,72,41,0,229
20,48,47,52,51,36,254
24,51,54,54,53,30,266
25,48,53,53,54,37,270
48,71,180,177,159,166,801
47,71,165,170,151,165,769
50,68,169,172,148,166,773
33,45,121,118,123,115,555
3,41,63,63,43,2,215
23,42,69,68,63,43,308
14,49,93,94,72,41,363
19,45,48,60,52,35,259
26,57,130,132,111,96,552
24,50,47,64,59,33,277
23,49,50,49,51,35,257
60,66,181,188,165,183,843
45,58,162,169,160,164,758
0,43,69,76,54,0,242
30,54,102,102,102,93,483
29,52,61,57,56,35,290
37,50,127,127,114,114,569
48,59,164,166,155,156,748
44,58,162,160,145,147,716
49,69,178,187,152,138,773
42,52,146,159,137,137,673
46,66,173,186,161,165,797
0,44,68,77,50,0,239
47,66,176,178,155,139,761
54,68,180,196,169,159,826
51,66,150,146,132,130,675
49,69,164,167,150,148,747
28,54,54,53,56,36,281
23,51,53,54,52,30,263
0,48,74,75,53,0,250
24,48,50,57,50,43,272
39,64,152,159,150,145,709
18,44,49,54,51,30,246
8,45,73,74,56,20,276
5,42,66,82,58,2,255
41,63,167,167,144,153,735
23,33,78,71,69,85,359
18,48,60,54,49,33,262
23,53,52,51,55,35,269
40,58,148,148,125,130,649
49,67,180,181,161,155,793
37,50,130,136,124,142,619
50,58,148,141,123,109,629
47,66,171,173,150,153,760
50,70,170,172,151,156,769
32,51,122,126,119,112,562
20,42,56,61,56,48,283
46,68,167,170,144,152,747
53,76,189,191,156,181,846
50,68,169,172,148,166,773
17,19,63,62,61,60,282
0,49,73,74,50,0,246
37,52,125,142,117,121,594
22,52,53,55,56,30,268
50,64,170,188,167,164,803
33,53,136,147,133,120,622
0,45,66,75,50,0,236
24,54,61,57,53,42,291
47,67,173,193,159,170,809
49,61,174,173,146,152,755
32,42,74,76,69,65,358
46,72,175,171,161,162,787
42,65,173,184,153,159,776
8,48,68,77,56,17,274
41,48,120,122,112,131,574
53,66,191,190,162,168,830
23,48,53,56,57,27,264
47,62,164,169,145,157,744
0,47,72,77,51,0,247
52,67,174,183,169,163,808
0,43,66,78,55,0,242
26,47,48,59,54,32,266
22,53,53,56,54,33,271
44,52,152,164,140,136,688
34,50,113,117,115,107,536
0,50,76,73,49,0,248
0,53,75,73,46,0,247
21,45,46,47,42,35,236
23,49,49,52,52,38,263
0,48,74,75,48,0,245
51,71,184,197,170,161,834
35,41,124,124,107,111,542
0,49,76,87,58,0,270
47,69,194,188,149,173,820
15,21,56,53,47,49,241
29,42,103,112,109,104,499
0,46,73,83,52,0,254
43,65,164,174,154,155,755
29,42,76,82,72,71,372
54,69,168,172,153,154,770
51,69,188,202,175,168,853
0,51,81,84,54,0,270
0,52,77,75,50,0,254
55,64,174,173,157,163,786
43,62,140,150,146,142,683
28,40,117,123,112,128,548
29,57,140,136,104,92,558
8,53,73,73,50,17,274
40,56,137,144,119,125,621
43,61,154,162,137,128,685
37,44,118,131,116,111,557
0,53,68,83,55,0,259
39,51,124,126,109,119,568
54,70,188,193,172,184,861
20,43,48,53,52,35,251
24,52,56,58,54,34,278
31,56,92,88,69,63,399
25,41,73,89,80,71,379
53,65,179,192,172,178,839
51,69,189,199,177,179,864
21,35,37,42,42,33,210
49,71,180,184,167,177,828
54,71,189,200,182,186,882
27,51,52,56,54,38,278
25,58,58,59,58,35,293
18,42,39,37,37,22,195
46,65,159,167,161,174,772
60,70,192,201,185,181,889
18,43,48,49,43,28,229
43,70,173,177,155,141,759
37,56,137,144,141,138,653
18,44,42,42,40,23,209
18,41,48,39,39,30,215
17,44,49,54,48,31,243
27,42,66,62,62,56,315
19,46,51,53,48,30,247
28,59,63,59,53,37,299
60,75,183,192,177,188,875
54,70,180,194,172,182,852
22,45,44,61,54,28,254
52,73,186,187,154,164,816
48,67,151,166,148,141,721
51,68,190,194,166,181,850
57,77,186,204,187,173,884
20,45,45,48,45,29,232
18,42,48,48,39,27,222
20,41,47,56,45,29,238
20,48,49,54,55,31,257
52,73,185,186,154,164,814
25,53,53,50,50,26,257
25,54,54,50,50,26,259
37,47,125,129,117,120,575
49,69,175,194,172,175,834
59,84,201,193,175,179,891
13,46,45,43,30,21,198
26,50,51,46,46,31,250
23,49,46,44,45,26,233
53,76,186,181,170,156,822
24,49,43,52,45,28,241
47,73,194,195,174,193,876
19,51,135,137,113,100,555
43,64,142,132,127,128,636
20,40,44,50,44,28,226
61,77,199,194,167,172,870
51,65,173,181,175,182,827
47,73,179,196,184,201,880
63,82,204,200,168,183,900
52,71,189,190,167,176,845
60,74,191,190,171,178,864
23,51,53,54,50,31,262
54,75,198,202,191,194,914
47,66,182,189,162,174,820
53,71,179,171,164,188,826
31,47,118,112,108,109,525
48,68,191,193,165,178,843
20,47,50,51,51,24,243
30,49,102,106,99,100,486
60,71,186,186,174,169,846
49,70,185,199,180,197,880
21,48,46,50,48,27,240
49,77,191,203,183,185,888
24,46,53,54,51,36,264
18,40,43,49,44,26,220
49,66,172,172,153,163,775
52,72,199,204,173,188,888
55,70,180,186,169,160,820
28,35,91,104,87,84,429
21,54,59,61,59,35,289
56,71,190,199,174,165,855
47,65,165,169,151,156,753
54,78,190,192,166,189,869
48,72,190,200,179,189,878
17,43,45,43,31,23,202
15,37,41,43,37,24,197
18,53,60,60,53,34,278
21,45,49,56,59,33,263
21,42,55,45,42,23,228
60,70,191,200,170,177,868
23,48,54,53,56,44,278
35,45,103,109,91,82,465
52,71,201,205,175,174,878
16,32,41,42,41,33,205
57,78,186,201,186,173,881
23,43,49,49,46,32,242
17,36,40,42,40,24,199
54,72,186,190,171,179,852
56,76,189,178,162,177,838
21,44,48,53,51,27,244
34,58,107,112,100,101,512
31,48,101,112,94,78,464
18,37,41,57,50,36,239
18,37,41,47,43,29,215
40,55,134,130,107,110,576
54,73,191,191,170,164,843
35,48,127,141,137,128,616
23,43,56,76,76,56,330
15,38,45,45,47,26,216
24,52,53,61,51,33,274
22,48,38,47,45,27,227
48,71,191,192,169,161,832
39,48,131,122,108,113,561
60,71,194,199,174,179,877
48,71,190,191,173,174,847
51,65,176,178,147,167,784
48,59,156,161,149,164,737
51,71,191,194,171,183,861
51,67,189,199,166,176,848
48,61,170,193,159,171,802
54,72,189,205,177,173,870
17,35,41,48,48,34,223
11,32,38,49,37,18,185
51,67,180,185,166,171,820
54,71,194,196,169,169,853
61,73,208,197,167,188,894
45,66,183,200,172,184,850
51,70,187,190,160,173,831
54,75,182,184,162,170,827
47,64,179,186,166,164,806
47,71,167,185,163,174,807
19,34,75,68,53,46,295
38,56,156,154,122,134,660
56,76,204,213,182,186,917
16,31,37,42,36,31,193
15,32,35,48,41,23,194
19,40,42,46,40,28,215
46,77,175,193,174,167,832
54,83,191,181,171,175,855
48,66,175,188,161,171,809
43,64,178,187,164,162,798
50,76,192,198,177,173,866
51,80,206,208,190,184,919
49,71,172,189,163,158,802
50,72,193,193,166,174,848
16,35,35,35,33,15,169
19,44,40,42,35,21,201
50,67,177,187,159,166,806
51,74,202,199,158,170,854
14,39,45,48,41,24,211
48,71,184,193,166,175,837
54,66,182,190,165,177,834
56,74,197,196,177,193,893
49,70,196,191,171,183,860
15,36,40,42,35,19,187
44,66,167,187,168,155,787
20,40,53,53,45,29,240
57,69,183,191,166,179,845
52,75,191,197,167,159,841
18,36,46,46,44,31,221
53,69,191,203,176,186,878
50,71,183,190,168,179,841
56,76,194,191,165,178,860
44,71,181,187,168,174,825
53,69,182,194,167,164,829
16,40,48,45,46,26,221
50,73,183,192,170,180,848
55,77,190,201,178,188,889
52,67,176,188,161,182,826
46,78,187,189,167,165,832
53,79,183,187,161,190,853
49,73,172,186,167,183,830
50,79,205,210,191,184,919
48,62,181,190,175,175,831
45,67,177,189,162,171,811
21,40,41,47,39,26,214
55,69,186,190,165,174,839
49,76,195,205,189,193,907
49,71,185,198,165,170,838
56,74,183,198,175,170,856
15,37,39,43,42,21,197
43,70,191,197,174,193,868
15,34,43,42,39,25,198
17,38,42,47,42,24,210
47,75,188,189,161,171,831
40,53,133,145,117,108,596
53,68,179,189,168,174,831
41,54,139,134,121,126,615
20,25,65,62,56,63,291
12,34,80,79,70,69,344
12,21,22,29,28,9,121
33,52,137,136,122,122,602
44,61,138,131,119,134,627
46,67,178,183,155,167,796
36,58,130,131,125,121,601
36,56,140,145,115,118,610
42,59,152,150,137,145,685
37,51,128,139,114,111,580
20,33,26,25,26,13,143
14,29,27,36,31,17,154
32,145,161,147,128,34,647
28,34,87,92,90,105,436
26,148,151,155,143,43,666
1,0,3,2,3,6,15
37,119,164,162,151,114,747
44,56,154,161,132,129,676
32,38,113,123,102,93,501
29,41,107,123,107,124,531
53,55,157,166,151,147,729
0,43,63,68,43,0,217
45,68,180,184,175,186,838
45,60,156,164,146,154,725
40,50,129,129,121,132,601
38,54,136,137,124,132,621
39,53,144,146,127,128,637
23,37,101,108,87,93,449
39,50,138,145,126,136,634
48,54,161,159,140,138,700
33,37,125,124,97,109,525
6,11,8,7,6,6,44
41,57,148,155,126,145,672
15,29,80,86,76,64,350
22,36,86,92,86,78,400
24,32,78,86,88,89,397
35,36,103,105,79,83,441
4,3,10,15,16,14,62
48,50,148,141,134,142,663
49,61,167,159,140,144,720
31,51,116,109,95,110,512
38,50,142,140,128,131,629
28,43,127,128,99,104,529
27,42,100,93,77,86,425
23,30,82,84,72,70,361
33,33,110,113,98,101,488
45,59,148,144,139,149,684
38,44,125,122,105,118,552
36,37,117,118,114,98,520
30,47,121,130,121,133,582
34,38,103,105,97,94,471
33,56,135,143,128,137,632
33,40,114,111,104,106,508
49,56,168,160,132,133,698
42,64,163,173,154,150,746
41,46,136,138,114,113,588
40,64,164,163,146,150,727
45,55,151,160,144,141,696
3,2,2,4,3,6,20
15,25,60,67,63,46,276
38,53,132,148,131,132,634
17,12,61,77,70,62,299
45,62,164,173,157,147,748
33,52,134,139,124,122,604
49,57,159,154,134,150,703
45,65,164,157,144,152,727
46,62,162,171,153,155,749
17,34,105,122,93,82,453
49,75,182,169,154,160,789
28,38,99,108,106,109,488
52,66,182,188,171,162,821
38,44,127,120,102,119,550
27,31,69,84,94,82,387
26,31,103,97,87,93,437
51,57,149,138,138,151,684
34,49,122,125,117,123,570
43,65,159,140,116,144,667
37,55,146,149,119,137,643
32,47,128,131,112,125,575
2,1,2,2,1,1,9
26,37,89,83,82,82,399
43,59,155,167,134,137,695
44,63,162,170,153,154,746
31,50,110,104,89,92,476
43,57,167,174,155,149,745
34,40,109,106,97,88,474
47,59,174,171,155,160,766
7,5,12,8,6,9,47
52,64,173,167,156,162,774
45,62,164,160,135,146,712
29,45,121,129,108,110,542
45,55,153,154,137,146,690
43,53,142,134,124,138,634
42,65,167,169,156,160,759
43,56,145,153,131,143,671
50,68,168,163,144,151,744
31,44,104,103,87,109,478
31,41,104,111,99,96,482
54,60,165,172,150,143,744
40,56,136,135,125,119,611
30,41,109,109,91,110,490
43,65,165,170,152,155,750
47,61,179,176,162,161,786
27,38,101,101,97,93,457
19,23,60,55,54,53,264
44,58,159,163,143,146,713
43,53,155,158,137,142,688
10,16,51,59,50,47,233
42,53,138,153,135,133,654
23,39,96,97,72,79,406
22,22,85,97,91,93,410
25,35,83,91,91,110,435
49,75,190,196,189,202,901
45,62,180,183,158,160,788
58,75,188,192,164,180,857
0,50,73,76,49,0,248
39,54,131,137,122,125,608
41,59,142,137,123,141,643
26,30,72,73,71,80,352
56,70,181,182,162,163,814
54,67,184,190,169,172,836
28,31,68,68,68,65,328
58,69,197,200,155,163,842
54,63,179,190,168,167,821
26,43,106,126,115,112,528
54,75,191,205,177,175,877
51,67,187,188,169,183,845
54,61,179,196,162,157,809
0,47,69,76,51,0,243
51,64,180,186,158,165,804
52,68,186,189,169,172,836
38,51,146,163,143,133,674
48,60,166,185,172,161,792
49,68,173,180,167,165,802
0,48,73,76,54,0,251
34,52,125,122,103,111,547
53,61,172,175,154,167,782
0,52,73,76,47,0,248
53,63,176,179,162,174,807
51,74,194,203,177,180,879
50,60,180,183,162,158,793
59,73,193,194,171,176,866
49,59,151,151,134,141,685
40,63,175,182,161,142,763
60,74,189,180,160,172,835
52,65,184,184,162,174,821
41,64,153,164,139,146,707
0,51,73,80,55,0,259
46,70,174,178,156,152,776
51,68,175,179,166,178,817
0,48,76,72,45,0,241
60,77,183,197,167,180,864
57,64,179,188,168,168,824
39,63,151,158,137,147,695
50,77,194,204,176,172,873
55,73,188,187,158,169,830
0,50,74,90,56,0,270
54,63,166,177,158,156,774
0,52,72,76,52,0,252
47,65,174,172,155,160,773
0,52,77,77,51,0,257
36,59,153,161,127,116,652
49,71,191,200,165,180,856
49,71,169,174,170,171,804
56,72,190,184,170,186,858
49,57,150,154,131,145,686
52,64,185,195,178,182,856
52,71,196,201,165,190,875
43,60,154,157,136,140,690
0,45,68,82,47,0,242
53,65,169,170,157,158,772
0,43,68,76,50,0,237
47,64,167,168,146,145,737
0,50,65,70,48,0,233
0,44,70,78,48,0,240
50,66,175,185,161,176,813
51,77,196,201,164,157,846
44,70,179,168,144,164,769
50,66,167,173,158,161,775
55,74,192,189,162,166,838
43,52,144,144,123,136,642
53,64,167,169,157,158,768
41,57,159,160,144,143,704
0,3,3,2,2,0,10
54,72,190,207,185,189,897
26,38,103,114,90,85,456
39,51,126,131,122,126,595
46,61,163,164,141,134,709
50,64,169,185,163,170,801
52,74,188,198,179,182,873
61,116,245,235,210,231,1098
43,55,147,156,138,138,677
43,59,161,148,126,146,683
40,46,136,132,124,117,595
16,24,79,77,55,80,331
46,64,163,164,150,163,750
22,27,83,82,68,63,345
21,23,68,72,65,83,332
28,46,108,113,103,108,506
45,59,159,158,143,148,712
46,54,151,144,127,133,655
40,48,134,138,108,121,589
56,69,181,182,158,152,798
51,74,178,173,155,172,803
46,58,164,160,137,146,711
38,47,135,125,105,117,567
37,60,148,140,119,132,636
44,69,162,137,112,141,665
41,50,149,142,118,140,640
31,39,112,118,105,99,504
43,47,134,141,130,136,631
34,37,122,128,113,109,543
36,47,115,123,126,135,582
43,63,152,142,125,139,664
46,63,153,150,134,135,681
36,47,129,129,117,114,572
18,22,62,64,59,56,281
43,59,151,146,127,134,660
39,43,127,135,126,120,590
32,36,95,97,93,86,439
54,70,169,168,159,171,791
31,39,96,95,85,90,436
49,55,154,153,135,169,715
48,70,177,171,155,158,779
43,58,153,158,122,119,653
31,52,118,119,107,115,542
33,35,107,113,97,85,470
30,44,108,105,98,110,495
23,32,88,94,85,91,413
27,33,89,78,62,88,377
24,23,78,85,77,87,374
27,34,96,98,84,75,414
27,34,96,98,84,75,414
24,32,85,94,86,83,404
24,34,79,73,58,68,336
22,27,72,76,67,55,319
6,5,10,15,12,9,57
16,14,62,76,70,56,294
16,23,69,74,69,70,321
44,54,136,144,131,146,655
3,4,3,3,2,4,19
24,46,111,120,100,98,499
29,34,88,86,90,82,409
36,42,109,104,100,96,487
31,32,90,85,89,100,427
23,37,73,71,62,59,325
41,51,152,154,138,136,672
24,33,101,98,90,106,452
34,44,127,135,115,123,578
30,39,94,107,92,89,451
21,24,52,52,49,38,236
29,46,102,105,88,96,466
25,22,69,65,63,64,308
2,1,2,4,3,6,18
16,17,50,60,51,52,246
19,28,65,69,61,66,308
51,55,158,175,158,159,756
58,71,191,187,169,176,852
48,58,164,162,144,146,722
30,39,95,81,67,63,375
18,36,64,49,47,56,270
18,36,64,49,47,56,270
53,69,182,203,186,164,857
49,67,176,182,162,164,800
53,67,186,184,154,166,810
46,71,188,194,175,178,852
53,68,173,183,159,171,807
50,59,165,165,153,148,740
55,72,190,178,175,171,841
52,69,187,183,169,179,839
49,72,180,187,167,167,822
38,52,134,129,102,108,563
45,58,165,179,167,163,777
38,55,126,126,112,125,582
38,61,137,141,127,143,647
38,58,148,164,138,137,683
25,31,82,75,72,72,357
48,63,145,145,131,141,673
51,68,179,180,151,148,777
25,46,105,114,108,100,498
36,46,124,129,111,111,557
39,54,136,133,110,106,578
39,54,136,133,110,106,578
36,57,151,166,142,134,686
45,67,155,152,124,140,683
28,43,112,105,88,96,472
26,32,86,71,60,63,338
43,58,147,158,139,132,677
44,59,144,154,139,149,689
45,65,159,151,131,143,694
35,56,150,161,150,142,694
57,76,194,195,180,178,880
58,68,186,190,166,162,830
30,38,97,102,98,97,462
17,36,94,94,92,91,424
53,69,178,173,152,160,785
53,70,179,188,175,168,833
30,40,102,107,91,104,474
33,48,127,132,114,123,577
29,45,119,121,114,99,527
26,33,101,113,98,91,462
55,75,188,188,169,168,843
40,59,158,156,145,159,717
43,59,159,153,126,141,681
48,64,170,172,153,160,767
32,42,110,120,103,111,518
37,57,137,122,102,107,562
39,60,155,157,150,157,718
44,43,140,144,135,153,659
26,29,74,90,92,106,417
40,48,134,137,122,137,618
31,36,99,91,88,102,447
38,48,136,128,106,129,585
33,51,133,142,125,138,622
47,57,156,153,132,151,696
46,67,178,179,165,169,804
42,57,164,173,147,151,734
48,66,174,191,169,185,833
51,76,184,189,173,180,853
53,67,177,202,171,179,849
51,69,171,172,160,169,792
33,51,143,136,117,117,597
57,73,204,175,167,185,861
56,69,197,205,169,166,862
41,63,174,184,150,146,758
48,61,173,171,149,157,759
52,70,174,177,147,150,770
58,66,189,189,173,170,845
47,62,162,158,144,149,722
44,63,149,153,143,164,716
49,72,197,189,170,183,860
45,57,173,178,155,146,754
42,57,154,162,145,149,709
55,72,188,188,164,164,831
45,65,180,187,164,165,806
49,66,167,163,137,139,721
49,64,163,170,146,149,741
31,53,130,133,122,120,589
34,53,134,135,114,135,605
30,48,124,120,120,130,572
43,62,178,184,172,173,812
47,71,177,176,155,172,798
48,70,187,186,166,171,828
39,51,147,157,130,133,657
35,54,122,120,106,107,544
50,68,186,184,168,160,816
52,70,193,194,168,173,850
50,76,197,193,173,177,866
50,67,179,185,162,160,803
50,67,179,185,162,160,803
44,68,184,180,147,163,786
54,72,181,174,173,177,831
54,66,184,185,166,174,829
54,77,202,198,175,181,887
56,71,187,172,143,158,787
53,69,189,193,165,185,854
47,71,200,198,163,181,860
32,36,113,122,109,116,528
53,75,202,196,175,173,874
33,47,128,123,106,107,544
56,77,201,206,177,178,895
54,76,196,187,161,180,854
49,65,171,180,157,167,789
48,74,185,186,168,181,842
38,57,154,155,141,139,684
55,68,203,189,159,175,849
59,72,188,207,178,173,877
54,71,185,196,168,174,848
57,71,198,204,172,174,876
49,65,174,196,168,176,828
19,25,69,73,62,76,324
53,72,181,183,170,196,855
54,67,182,187,173,176,839
54,79,196,198,182,174,883
48,76,200,192,171,165,852
56,69,191,195,170,172,853
53,70,190,190,164,175,842
50,57,170,180,149,165,771
45,58,157,182,164,174,780
54,64,178,186,175,169,826
52,74,189,184,161,176,836
48,64,172,180,156,159,779
53,72,189,187,149,157,807
45,60,155,172,147,150,729
48,67,176,182,156,164,793
47,67,185,203,173,169,844
41,54,140,147,135,129,646
49,73,185,189,166,157,819
45,60,165,184,171,171,796
47,72,178,172,149,156,774
51,69,174,186,154,183,817
40,56,145,155,131,137,664
46,52,142,154,127,123,644
15,20,62,75,61,63,296
57,72,202,204,172,178,885
360,864,1716,1743,1379,1704,7766
42,51,132,134,113,130,602
37,53,129,135,126,120,600
51,73,171,179,159,155,788
42,56,159,160,135,165,717
39,48,153,155,129,118,642
35,58,155,167,151,151,717
43,55,152,175,154,157,736
45,59,155,158,144,139,700
45,60,151,172,155,144,727
42,63,165,164,140,157,731
39,61,155,169,150,157,731
46,63,153,163,141,157,723
52,67,173,179,152,162,785
20,21,74,73,52,46,286
40,43,116,116,109,100,524
37,38,106,101,96,114,492
40,46,122,108,99,107,522
24,41,107,113,106,115,506
28,39,103,117,120,124,531
40,49,140,153,131,140,653
32,45,121,110,85,87,480
52,74,182,180,171,186,845
52,75,182,181,165,190,845
50,57,170,174,160,163,774
39,49,143,160,141,153,685
51,72,178,180,163,174,818
45,68,175,176,156,162,782
35,46,110,110,103,109,513
28,55,118,118,101,92,512
49,71,193,183,165,179,840
56,75,190,187,165,177,850
48,69,184,181,167,179,828
18,32,77,81,74,76,358
53,73,185,193,171,173,848
53,71,184,190,172,168,838
51,70,187,187,167,184,846
48,70,191,189,157,168,823
55,73,199,200,175,167,869
55,74,187,191,171,185,863
50,66,181,191,166,169,823
48,56,173,181,156,156,770
55,78,186,179,161,180,839
410,1059,2193,2159,1992,2201,10014
225,572,1188,1195,1083,1164,5427
52,71,179,184,165,180,831
0,50,76,77,51,0,254
47,57,154,164,144,140,706
0,48,66,69,46,0,229
0,50,70,73,46,0,239
0,48,67,71,46,0,232
0,50,72,73,47,0,242
53,71,194,192,171,173,854
44,56,155,161,137,133,686
52,68,187,190,169,170,836
49,64,190,199,154,165,821
36,49,147,163,132,124,651
41,67,185,190,167,163,813
0,49,70,72,50,0,241
54,73,177,172,157,172,805
45,68,171,172,154,163,773
40,58,158,160,139,142,697
44,61,163,166,149,151,734
59,72,213,216,178,177,915
51,68,179,194,173,171,836
50,69,173,170,158,159,779
52,58,169,171,152,173,775
47,66,173,173,153,163,775
46,65,174,179,149,164,777
43,54,138,146,131,137,649
36,58,138,146,130,145,653
49,61,158,164,145,147,724
49,66,160,161,154,167,757
53,72,186,191,165,169,836
43,60,167,182,151,145,748
42,67,162,177,155,159,762
54,73,185,179,160,167,818
50,65,184,197,162,159,817
44,70,182,187,167,161,811
48,67,189,195,176,176,851
50,67,188,195,177,178,855
59,71,183,189,168,174,844
68,69,193,184,167,160,841
55,73,203,196,169,168,864
51,72,177,194,181,161,836
51,69,179,204,173,181,857
57,76,196,191,164,178,862
0,55,77,76,53,0,261
0,55,77,76,53,0,261
0,51,76,84,51,0,262
53,71,185,197,185,170,861
53,75,180,197,179,172,856
55,71,185,188,165,180,844
53,69,189,195,153,133,792
53,72,182,190,173,168,838
50,68,172,194,180,183,847
53,72,184,199,183,186,877
45,61,146,159,142,139,692
49,63,171,178,151,158,770
49,61,162,176,149,141,738
47,60,166,176,162,165,776
47,60,166,176,162,165,776
48,79,173,181,161,165,807
52,68,181,191,155,152,799
54,70,183,191,168,171,837
53,67,183,197,178,170,848
46,64,173,183,153,174,793
48,67,178,176,156,181,806
45,56,157,166,136,146,706
49,72,182,202,160,174,839
51,61,173,197,165,157,804
53,61,176,185,154,155,784
52,67,186,191,165,169,830
26,40,98,96,84,87,431
41,49,128,143,134,137,632
53,73,182,184,161,168,821
36,60,156,160,134,128,674
39,57,134,137,117,113,597
46,58,154,165,138,145,706
51,73,196,213,162,153,848
53,70,204,216,178,173,894
44,66,163,170,160,169,772
49,67,169,171,152,152,760
53,72,180,179,145,158,787
46,68,180,189,160,156,799
52,69,191,193,161,172,838
32,51,121,126,110,104,544
40,55,143,140,124,122,624
53,70,195,196,172,175,861
42,59,143,140,124,124,632
37,53,143,152,125,126,636
42,50,130,141,117,119,599
0,49,70,70,46,0,235
0,48,69,74,48,0,239
52,70,186,185,170,183,846
53,69,187,191,173,178,851
55,69,174,171,164,170,803
57,77,200,197,167,177,875
57,77,200,197,167,177,875
54,69,195,194,163,162,837
56,67,185,201,172,175,856
56,76,185,176,162,172,827
53,73,197,190,165,172,850
25,48,107,113,92,85,470
54,59,187,207,183,196,886
45,58,172,168,141,158,742
55,75,198,198,174,167,867
29,36,98,103,89,78,433
0,48,72,72,45,0,237
0,41,61,72,54,0,228
46,73,185,211,183,176,874
0,48,69,71,45,0,233
0,49,72,83,60,0,264
33,52,137,134,121,127,604
13,39,76,90,72,55,345
18,44,90,95,75,50,372
44,58,149,169,160,133,713
0,47,66,75,45,0,233
0,52,68,71,49,0,240
47,69,184,198,180,178,856
51,69,184,179,165,175,823
20,30,73,82,70,66,341
44,66,167,186,159,160,782
49,68,180,189,174,149,809
0,49,74,76,51,0,250
0,45,67,79,56,0,247
0,48,73,75,51,0,247
0,48,73,69,43,0,233
0,56,72,72,46,0,246
0,51,75,79,45,0,250
59,72,199,200,175,175,880
0,41,67,71,44,0,223
60,70,201,212,182,180,905
55,73,194,194,173,169,858
48,67,173,172,151,146,757
40,59,146,159,155,141,700
0,48,70,71,46,0,235
45,65,189,190,168,181,838
38,48,128,141,124,141,620
48,58,179,192,165,154,796
51,73,187,204,175,172,862
21,49,49,50,49,31,249
55,69,193,203,177,174,871
49,70,193,187,159,159,817
47,76,157,158,137,148,723
50,71,167,166,154,159,767
31,55,130,128,104,92,540
30,51,91,93,83,77,425
45,61,168,183,154,166,777
50,68,173,173,168,170,802
36,50,126,119,101,109,541
23,46,55,60,57,35,276
39,59,94,83,80,67,422
29,42,72,71,60,62,336
23,45,49,46,47,24,234
0,40,67,79,52,0,238
23,49,54,54,50,29,259
39,49,144,164,142,134,672
24,32,81,76,75,83,371
39,58,135,137,112,121,602
46,66,175,174,157,166,784
0,44,70,74,47,0,235
48,63,187,180,148,160,786
24,52,119,120,100,90,505
2,45,73,77,47,1,245
53,75,177,187,159,163,814
51,70,186,195,170,173,845
0,48,73,81,51,0,253
24,48,54,57,53,34,270
31,44,105,104,103,102,489
50,55,164,165,144,147,725
29,55,91,93,81,64,413
1,46,59,60,40,1,207
55,70,191,200,179,196,891
49,72,189,186,168,172,836
55,75,189,192,179,192,882
22,48,53,51,53,35,262
16,20,58,55,42,50,241
18,41,40,39,38,23,199
19,34,42,43,42,26,206
53,72,188,210,189,174,886
53,70,177,177,163,174,814
19,23,62,54,52,60,270
24,49,48,56,50,33,260
54,71,183,191,176,173,848
29,49,111,124,125,114,552
57,74,201,206,170,178,886
56,76,193,199,175,183,882
26,53,54,48,44,39,264
5,4,5,7,10,3,34
33,45,115,127,99,96,515
24,35,101,108,106,108,482
56,74,184,197,179,185,875
57,74,192,193,174,179,869
59,73,183,195,176,175,861
49,72,187,189,173,178,848
52,69,192,191,172,179,855
23,50,44,51,46,26,240
51,69,188,200,181,177,866
50,69,183,192,176,179,849
57,75,201,205,175,191,904
62,82,204,199,177,174,898
48,66,180,192,169,161,816
49,64,174,193,172,183,835
51,61,182,187,177,177,835
21,42,54,50,38,17,222
51,68,176,192,166,174,827
47,67,169,172,138,151,744
47,64,173,178,155,157,774
54,72,200,194,164,174,858
45,64,165,177,152,143,746
15,40,41,39,35,21,191
52,69,194,188,159,164,826
19,40,42,47,40,22,210
55,71,196,200,172,170,864
50,74,187,204,174,166,855
47,75,187,191,169,177,846
55,63,200,207,168,176,869
9,30,32,40,35,19,165
50,78,204,221,184,174,911
16,41,42,45,35,19,198
19,41,47,50,46,26,229
16,42,48,47,38,23,214
14,43,45,37,36,24,199
17,40,45,45,35,24,206
30,47,129,137,118,110,571
54,77,193,199,179,184,886
36,58,131,144,124,124,617
46,65,167,170,147,164,759
47,70,172,181,159,180,809
50,71,202,212,170,168,873
55,71,188,189,162,170,835
46,77,182,191,178,168,842
52,74,203,199,158,170,856
26,38,105,91,80,92,432
14,33,40,46,38,25,196
53,72,175,171,152,161,784
50,65,176,186,163,177,817
48,66,182,194,168,166,824
48,68,172,191,173,166,818
45,68,172,191,169,170,815
51,74,191,201,165,176,858
14,32,34,32,31,21,164
15,36,38,44,31,16,180
54,74,195,190,166,185,864
17,35,38,43,39,23,195
46,63,156,159,132,137,693
18,40,40,48,41,26,213
17,39,42,44,41,25,208
51,73,181,193,164,168,830
27,38,115,104,88,86,458
58,75,185,192,163,162,835
55,75,180,179,161,182,832
50,70,177,177,152,157,783
44,70,172,185,165,166,802
40,64,168,177,155,163,767
39,64,165,171,163,162,764
32,40,113,126,109,104,524
46,57,133,125,112,113,586
44,57,158,163,146,149,717
47,61,162,169,154,158,751
17,36,41,35,32,22,183
22,31,79,86,82,69,369
14,35,87,92,78,77,383
12,32,29,25,25,15,138
15,29,22,34,31,12,143
50,72,196,196,164,174,852
42,67,154,150,142,159,714
46,63,144,151,136,154,694
16,29,34,41,33,20,173
28,130,142,132,126,31,589
13,44,48,49,42,23,219
23,146,166,153,127,42,657
23,33,96,104,83,77,416
6,7,17,17,15,10,72
23,41,100,113,101,110,488
41,52,154,157,130,133,667
7,9,13,14,9,9,61
53,49,154,163,144,158,721
1,2,3,5,5,1,17
36,55,124,140,121,109,585
0,6,6,3,2,0,17
0,34,48,54,35,0,171
0,44,69,68,45,0,226
39,55,127,128,111,124,584
38,62,156,171,161,159,747
29,49,111,106,99,103,497
31,44,101,99,94,118,487
49,57,172,173,163,159,773
28,28,77,76,63,68,340
22,34,95,97,95,105,448
45,53,157,152,131,131,669
52,72,204,210,190,194,922
16,37,42,46,40,23,204
21,23,68,66,56,55,289
25,32,90,98,93,93,431
45,54,156,166,146,159,726
41,63,157,171,154,169,755
36,52,126,129,103,98,544
39,60,139,135,124,133,630
52,71,177,179,151,167,797
52,72,192,192,170,185,863
43,58,161,160,135,135,692
46,60,162,163,138,160,729
34,37,118,136,117,120,562
33,42,112,116,105,91,499
46,58,174,182,151,165,776
46,67,180,184,162,167,806
52,71,190,189,169,173,844
41,63,162,161,134,138,699
42,61,153,159,151,153,719
56,66,179,177,161,164,803
48,73,178,180,145,154,778
50,73,183,189,172,179,846
54,73,180,188,168,174,837
46,61,160,170,151,161,749
40,56,136,142,128,128,630
42,63,146,152,140,142,685
43,64,145,161,151,150,714
31,42,98,108,97,90,466
43,63,149,160,138,151,704
0,50,69,66,49,0,234
0,51,75,79,50,0,255
0,41,64,73,47,0,225
55,68,179,190,170,161,823
0,52,72,70,43,0,237
0,39,56,66,48,0,209
50,65,176,180,160,174,805
47,64,189,192,163,176,831
6,40,72,71,59,31,279
13,44,78,82,67,47,331
40,68,173,180,168,180,809
35,46,112,113,105,110,521
54,75,207,207,185,191,919
36,43,121,127,110,139,576
20,47,49,54,51,32,253
0,45,65,74,46,0,230
23,48,52,57,53,32,265
22,54,50,51,50,30,257
0,53,74,76,46,0,249
23,47,49,53,52,34,258
26,52,52,52,48,29,259
35,47,140,156,140,142,660
17,31,37,30,30,21,166
7,9,39,43,45,51,194
49,69,182,183,160,162,805
34,54,146,151,126,114,625
15,25,46,47,47,50,230
25,36,93,99,86,83,422
3,7,12,13,20,27,82
35,57,135,145,120,110,602
19,22,64,65,61,73,304
54,71,182,167,161,166,801
44,61,156,161,144,148,714
32,40,100,92,92,87,443
50,55,164,153,146,152,720
25,40,92,100,99,98,454
48,72,185,181,166,180,832
18,27,72,77,72,83,349
44,63,162,163,134,139,705
44,58,160,162,145,165,734
43,67,158,158,142,136,704
42,61,153,159,150,152,717
30,43,108,113,103,109,506
49,64,162,158,147,137,717
24,43,111,111,99,101,489
30,46,111,119,98,92,496
32,39,117,117,114,119,538
42,62,167,170,149,164,754
55,72,185,192,175,175,854
46,57,182,195,164,164,808
47,58,152,166,150,147,720
50,72,192,198,179,179,870
47,71,186,184,165,178,831
51,68,189,181,159,162,810
53,68,179,192,164,169,825
49,61,165,179,162,167,783
51,59,173,177,151,161,772
40,53,136,140,124,130,623
42,67,156,173,143,154,735
57,68,182,189,175,186,857
56,76,213,209,163,164,881
0,48,70,79,52,0,249
0,49,71,70,41,0,231
38,61,163,169,140,141,712
37,61,145,154,133,147,677
37,61,145,154,133,147,677
15,24,67,62,49,46,263
53,71,182,190,161,150,807
25,36,98,101,94,82,436
39,52,138,137,125,139,630
0,52,75,83,52,0,262
50,73,177,196,170,167,833
44,61,153,166,159,156,739
51,71,185,191,175,178,851
50,65,176,194,172,184,841
44,64,186,190,175,178,837
57,70,185,188,173,183,856
55,64,170,180,166,168,803
19,24,72,86,78,59,338
14,20,50,65,57,44,250
24,28,72,75,62,78,339
51,63,167,177,164,173,795
34,45,115,126,103,92,515
21,29,72,78,72,64,336
20,27,75,72,70,76,340
20,28,81,85,78,75,367
53,69,197,194,159,173,845
50,58,174,184,159,160,785
55,65,170,173,155,162,780
29,32,98,101,87,78,425
40,56,165,168,143,150,722
49,70,192,189,156,178,834
60,75,187,185,181,179,867
41,63,162,161,134,138,699
40,48,131,138,115,116,588
34,36,112,128,117,113,540
45,56,150,173,158,151,733
51,61,157,162,146,147,724
53,73,182,178,153,167,806
23,46,51,55,55,30,260
23,46,53,49,46,31,248
41,57,140,132,114,118,602
46,60,169,169,138,141,723
46,67,184,192,160,164,813
43,55,143,144,127,156,668
36,52,123,124,113,121,569
36,51,146,158,132,134,657
47,60,157,155,134,146,699
42,69,158,148,133,144,694
24,47,48,52,53,34,258
38,46,137,141,129,120,611
41,57,139,139,116,122,614
16,25,65,64,66,59,295
37,57,144,156,141,154,689
2,1,6,8,7,4,28
52,68,177,186,160,174,817
16,46,45,47,39,20,213
42,51,138,138,122,126,617
38,50,137,133,120,126,604
36,52,142,125,98,110,563
38,60,147,161,144,152,702
38,60,147,161,144,152,702
25,29,66,72,71,75,338
36,60,142,158,138,134,668
35,50,135,128,125,142,615
45,57,148,143,126,154,673
33,38,124,139,122,124,580
26,43,117,123,107,118,534
20,30,80,85,71,75,361
52,67,176,176,150,161,782
45,58,165,163,130,141,702
19,29,58,64,54,44,268
23,26,71,70,60,63,313
22,26,81,88,74,77,368
24,32,85,78,87,103,409
54,77,192,188,167,175,853
51,75,181,174,157,174,812
50,67,171,168,160,167,783
42,58,138,138,133,136,645
12,25,28,31,25,19,140
44,66,173,172,145,147,747
49,66,164,154,134,157,724
32,41,101,102,87,84,447
28,48,125,131,114,120,566
49,62,184,195,164,168,822
23,27,71,68,73,79,341
16,27,75,86,79,79,362
28,33,88,85,74,81,389
8,9,13,20,22,19,91
39,57,157,156,142,150,701
30,41,101,111,97,103,483
31,38,113,109,88,104,483
36,50,110,107,102,114,519
4,5,4,9,9,9,40
5,6,8,9,10,10,48
33,46,121,135,134,128,597
3,2,2,3,1,2,13
53,63,177,174,158,159,784
51,58,168,172,149,149,747
18,36,37,42,40,19,192
6,5,5,6,7,3,32
2,3,14,15,10,6,50
2,2,2,3,2,6,17
27,29,85,87,77,95,400
48,56,147,151,141,147,690
21,28,72,84,77,64,346
20,24,66,70,67,59,306
26,38,99,100,86,96,445
50,68,181,180,153,169,801
38,47,136,148,132,134,635
48,78,191,199,182,188,886
25,29,77,76,75,68,350
24,32,70,75,73,60,334
22,31,80,74,66,69,342
7,9,39,43,45,51,194
29,32,91,97,82,76,407
17,21,62,64,47,47,258
27,44,108,111,93,104,487
2,3,2,7,6,8,28
22,23,67,70,67,66,315
5,3,4,5,4,2,23
24,40,87,85,85,92,413
26,38,98,88,77,78,405
26,35,97,95,77,89,419
22,31,76,74,71,74,348
28,41,97,99,91,92,448
39,53,140,147,133,134,646
3,5,2,5,6,9,30
23,51,50,49,49,41,263
4,6,10,10,13,9,52
36,54,135,139,129,136,629
52,67,172,183,167,181,822
45,53,158,152,138,140,686
48,69,181,193,157,168,816
28,37,83,84,75,63,370
52,66,191,193,174,177,853
54,70,188,186,172,180,850
51,72,182,193,163,169,830
48,77,187,189,173,165,839
15,25,24,25,19,10,118
13,25,60,63,62,60,283
57,71,201,199,164,164,856
35,56,142,137,128,152,650
